"filename", "language", "XML", "JavaScript", "CSS", "JSON", "HTML", "comment", "blank", "total"
"/Users/jonathanoakes/Desktop/breakfast-and-afterschool-club/index.html", "HTML", 0, 0, 0, 0, 21, 0, 1, 22
"/Users/jonathanoakes/Desktop/breakfast-and-afterschool-club/netlify/functions/create-payment-intent.js", "JavaScript", 0, 23, 0, 0, 0, 0, 6, 29
"/Users/jonathanoakes/Desktop/breakfast-and-afterschool-club/netlify/functions/send-account-closure-message.js", "JavaScript", 0, 24, 0, 0, 0, 0, 5, 29
"/Users/jonathanoakes/Desktop/breakfast-and-afterschool-club/netlify/functions/send-contact-form-message.js", "JavaScript", 0, 23, 0, 0, 0, 0, 5, 28
"/Users/jonathanoakes/Desktop/breakfast-and-afterschool-club/package.json", "JSON", 0, 0, 0, 51, 0, 0, 1, 52
"/Users/jonathanoakes/Desktop/breakfast-and-afterschool-club/public/manifest.json", "JSON", 0, 0, 0, 32, 0, 0, 1, 33
"/Users/jonathanoakes/Desktop/breakfast-and-afterschool-club/src/App.css", "CSS", 0, 0, 3, 0, 0, 0, 1, 4
"/Users/jonathanoakes/Desktop/breakfast-and-afterschool-club/src/App.jsx", "JavaScript", 0, 180, 0, 0, 0, 0, 11, 191
"/Users/jonathanoakes/Desktop/breakfast-and-afterschool-club/src/assets/arrow-left-1.svg", "XML", 16, 0, 0, 0, 0, 0, 0, 16
"/Users/jonathanoakes/Desktop/breakfast-and-afterschool-club/src/assets/crayons.svg", "XML", 152, 0, 0, 0, 0, 0, 1, 153
"/Users/jonathanoakes/Desktop/breakfast-and-afterschool-club/src/assets/loader.svg", "XML", 8, 0, 0, 0, 0, 0, 0, 8
"/Users/jonathanoakes/Desktop/breakfast-and-afterschool-club/src/assets/pencil.svg", "XML", 45, 0, 0, 0, 0, 0, 1, 46
"/Users/jonathanoakes/Desktop/breakfast-and-afterschool-club/src/assets/stripe-logo.svg", "XML", 1, 0, 0, 0, 0, 4, 0, 5
"/Users/jonathanoakes/Desktop/breakfast-and-afterschool-club/src/components/custom-button/custom-button.component.jsx", "JavaScript", 0, 5, 0, 0, 0, 0, 3, 8
"/Users/jonathanoakes/Desktop/breakfast-and-afterschool-club/src/components/errors/error-fallback.component.jsx", "JavaScript", 0, 8, 0, 0, 0, 0, 3, 11
"/Users/jonathanoakes/Desktop/breakfast-and-afterschool-club/src/components/errors/network-error.component.jsx", "JavaScript", 0, 39, 0, 0, 0, 0, 8, 47
"/Users/jonathanoakes/Desktop/breakfast-and-afterschool-club/src/components/floating-add-button/floating-add-button.component.jsx", "JavaScript", 0, 11, 0, 0, 0, 0, 4, 15
"/Users/jonathanoakes/Desktop/breakfast-and-afterschool-club/src/components/floating-back-button/floating-back-button.component.jsx", "JavaScript", 0, 53, 0, 0, 0, 0, 11, 64
"/Users/jonathanoakes/Desktop/breakfast-and-afterschool-club/src/components/floating-back-button/use-back-button.js", "JavaScript", 0, 24, 0, 0, 0, 0, 8, 32
"/Users/jonathanoakes/Desktop/breakfast-and-afterschool-club/src/components/loader/loader.component.jsx", "JavaScript", 0, 10, 0, 0, 0, 0, 3, 13
"/Users/jonathanoakes/Desktop/breakfast-and-afterschool-club/src/components/magic-url-button/magic-url-button.component.jsx", "JavaScript", 0, 19, 0, 0, 0, 0, 6, 25
"/Users/jonathanoakes/Desktop/breakfast-and-afterschool-club/src/components/private-routes/private-routes.component.jsx", "JavaScript", 0, 9, 0, 0, 0, 0, 5, 14
"/Users/jonathanoakes/Desktop/breakfast-and-afterschool-club/src/components/progressive-image/progressive-image.component.jsx", "JavaScript", 0, 26, 0, 0, 0, 0, 7, 33
"/Users/jonathanoakes/Desktop/breakfast-and-afterschool-club/src/components/social-logins/sections/brave.component.jsx", "JavaScript", 0, 22, 0, 0, 0, 0, 3, 25
"/Users/jonathanoakes/Desktop/breakfast-and-afterschool-club/src/components/social-logins/sections/chrome.component.jsx", "JavaScript", 0, 19, 0, 0, 0, 0, 3, 22
"/Users/jonathanoakes/Desktop/breakfast-and-afterschool-club/src/components/social-logins/sections/firefox.component.jsx", "JavaScript", 0, 18, 0, 0, 0, 0, 3, 21
"/Users/jonathanoakes/Desktop/breakfast-and-afterschool-club/src/components/social-logins/sections/info.component.jsx", "JavaScript", 0, 44, 0, 0, 0, 0, 4, 48
"/Users/jonathanoakes/Desktop/breakfast-and-afterschool-club/src/components/social-logins/sections/safari.component.jsx", "JavaScript", 0, 29, 0, 0, 0, 0, 3, 32
"/Users/jonathanoakes/Desktop/breakfast-and-afterschool-club/src/components/social-logins/sections/troubleshooting.component.jsx", "JavaScript", 0, 16, 0, 0, 0, 0, 3, 19
"/Users/jonathanoakes/Desktop/breakfast-and-afterschool-club/src/components/social-logins/social-logins-info.component.jsx", "JavaScript", 0, 49, 0, 0, 0, 0, 8, 57
"/Users/jonathanoakes/Desktop/breakfast-and-afterschool-club/src/components/social-logins/social-logins.component.jsx", "JavaScript", 0, 42, 0, 0, 0, 0, 12, 54
"/Users/jonathanoakes/Desktop/breakfast-and-afterschool-club/src/components/tables/default-table.component.jsx", "JavaScript", 0, 49, 0, 0, 0, 0, 3, 52
"/Users/jonathanoakes/Desktop/breakfast-and-afterschool-club/src/components/tables/no-search-result.component.jsx", "JavaScript", 0, 0, 0, 0, 0, 17, 3, 20
"/Users/jonathanoakes/Desktop/breakfast-and-afterschool-club/src/components/tables/searching-dates-help.component.jsx", "JavaScript", 0, 0, 0, 0, 0, 59, 4, 63
"/Users/jonathanoakes/Desktop/breakfast-and-afterschool-club/src/components/tables/table-checkbox.jsx", "JavaScript", 0, 14, 0, 0, 0, 0, 5, 19
"/Users/jonathanoakes/Desktop/breakfast-and-afterschool-club/src/components/tables/table-no-entries-info.component.jsx", "JavaScript", 0, 14, 0, 0, 0, 0, 3, 17
"/Users/jonathanoakes/Desktop/breakfast-and-afterschool-club/src/components/tables/table-search-box.component.jsx", "JavaScript", 0, 0, 0, 0, 0, 61, 13, 74
"/Users/jonathanoakes/Desktop/breakfast-and-afterschool-club/src/components/wallet-balance/wallet-balance.component.jsx", "JavaScript", 0, 19, 0, 0, 0, 0, 5, 24
"/Users/jonathanoakes/Desktop/breakfast-and-afterschool-club/src/functions/capitalize-string.js", "JavaScript", 0, 8, 0, 0, 0, 0, 2, 10
"/Users/jonathanoakes/Desktop/breakfast-and-afterschool-club/src/functions/create-session-types-and-prices-object.js", "JavaScript", 0, 30, 0, 0, 0, 0, 1, 31
"/Users/jonathanoakes/Desktop/breakfast-and-afterschool-club/src/functions/open-email-link.js", "JavaScript", 0, 7, 0, 0, 0, 0, 3, 10
"/Users/jonathanoakes/Desktop/breakfast-and-afterschool-club/src/functions/price-multiplied-by-100.js", "JavaScript", 0, 3, 0, 0, 0, 0, 1, 4
"/Users/jonathanoakes/Desktop/breakfast-and-afterschool-club/src/functions/validate-email.js", "JavaScript", 0, 4, 0, 0, 0, 0, 1, 5
"/Users/jonathanoakes/Desktop/breakfast-and-afterschool-club/src/global-styles.js", "JavaScript", 0, 56, 0, 0, 0, 0, 7, 63
"/Users/jonathanoakes/Desktop/breakfast-and-afterschool-club/src/hooks/use-cancel-and-return.js", "JavaScript", 0, 27, 0, 0, 0, 0, 7, 34
"/Users/jonathanoakes/Desktop/breakfast-and-afterschool-club/src/hooks/use-confirm-swal.js", "JavaScript", 0, 72, 0, 0, 0, 0, 7, 79
"/Users/jonathanoakes/Desktop/breakfast-and-afterschool-club/src/hooks/use-fire-swal.js", "JavaScript", 0, 33, 0, 0, 0, 0, 5, 38
"/Users/jonathanoakes/Desktop/breakfast-and-afterschool-club/src/hooks/use-get-user-on-load.js", "JavaScript", 0, 17, 0, 0, 0, 0, 5, 22
"/Users/jonathanoakes/Desktop/breakfast-and-afterschool-club/src/hooks/use-get-window-width.js", "JavaScript", 0, 22, 0, 0, 0, 0, 8, 30
"/Users/jonathanoakes/Desktop/breakfast-and-afterschool-club/src/hooks/use-hamburger-handler-navigate.js", "JavaScript", 0, 32, 0, 0, 0, 0, 9, 41
"/Users/jonathanoakes/Desktop/breakfast-and-afterschool-club/src/hooks/use-is-mobile-device.js", "JavaScript", 0, 34, 0, 0, 0, 0, 7, 41
"/Users/jonathanoakes/Desktop/breakfast-and-afterschool-club/src/hooks/use-is-online.js", "JavaScript", 0, 34, 0, 0, 0, 0, 9, 43
"/Users/jonathanoakes/Desktop/breakfast-and-afterschool-club/src/hooks/use-is-route-with-nav-warning.js", "JavaScript", 0, 19, 0, 0, 0, 0, 6, 25
"/Users/jonathanoakes/Desktop/breakfast-and-afterschool-club/src/hooks/use-reset-store.js", "JavaScript", 0, 103, 0, 0, 0, 0, 7, 110
"/Users/jonathanoakes/Desktop/breakfast-and-afterschool-club/src/hooks/use-session-prices-listener.js", "JavaScript", 0, 39, 0, 0, 0, 0, 9, 48
"/Users/jonathanoakes/Desktop/breakfast-and-afterschool-club/src/hooks/use-wallet-balance-listener.js", "JavaScript", 0, 25, 0, 0, 0, 0, 8, 33
"/Users/jonathanoakes/Desktop/breakfast-and-afterschool-club/src/index.css", "CSS", 0, 0, 12, 0, 0, 0, 2, 14
"/Users/jonathanoakes/Desktop/breakfast-and-afterschool-club/src/main.jsx", "JavaScript", 0, 25, 0, 0, 0, 0, 3, 28
"/Users/jonathanoakes/Desktop/breakfast-and-afterschool-club/src/routes/account/account-button-links.component.jsx", "JavaScript", 0, 37, 0, 0, 0, 0, 8, 45
"/Users/jonathanoakes/Desktop/breakfast-and-afterschool-club/src/routes/account/account-hooks/use-check-for-and-clear-form-details.js", "JavaScript", 0, 44, 0, 0, 0, 0, 8, 52
"/Users/jonathanoakes/Desktop/breakfast-and-afterschool-club/src/routes/account/account-hooks/use-navigate-to-route.js", "JavaScript", 0, 71, 0, 0, 0, 0, 7, 78
"/Users/jonathanoakes/Desktop/breakfast-and-afterschool-club/src/routes/account/account-stripe-logo.component.jsx", "JavaScript", 0, 22, 0, 0, 0, 0, 7, 29
"/Users/jonathanoakes/Desktop/breakfast-and-afterschool-club/src/routes/account/account.component.jsx", "JavaScript", 0, 21, 0, 0, 0, 0, 8, 29
"/Users/jonathanoakes/Desktop/breakfast-and-afterschool-club/src/routes/account/intro.component.jsx", "JavaScript", 0, 16, 0, 0, 0, 0, 7, 23
"/Users/jonathanoakes/Desktop/breakfast-and-afterschool-club/src/routes/add-child-info/add-child-info-button.component.jsx", "JavaScript", 0, 33, 0, 0, 0, 0, 10, 43
"/Users/jonathanoakes/Desktop/breakfast-and-afterschool-club/src/routes/add-child-info/add-child-info-form.component.jsx", "JavaScript", 0, 78, 0, 0, 0, 0, 16, 94
"/Users/jonathanoakes/Desktop/breakfast-and-afterschool-club/src/routes/add-child-info/add-child-info-hooks/use-add-child-info-result-swal.js", "JavaScript", 0, 55, 0, 0, 0, 0, 10, 65
"/Users/jonathanoakes/Desktop/breakfast-and-afterschool-club/src/routes/add-child-info/add-child-info-hooks/use-confirm-add-child-info.js", "JavaScript", 0, 37, 0, 0, 0, 0, 11, 48
"/Users/jonathanoakes/Desktop/breakfast-and-afterschool-club/src/routes/add-child-info/add-child-info-hooks/use-handle-add-child-info-change.js", "JavaScript", 0, 13, 0, 0, 0, 0, 6, 19
"/Users/jonathanoakes/Desktop/breakfast-and-afterschool-club/src/routes/add-child-info/add-child-info.component.jsx", "JavaScript", 0, 22, 0, 0, 0, 0, 10, 32
"/Users/jonathanoakes/Desktop/breakfast-and-afterschool-club/src/routes/add-funds/add-funds-button.component.jsx", "JavaScript", 0, 18, 0, 0, 0, 0, 5, 23
"/Users/jonathanoakes/Desktop/breakfast-and-afterschool-club/src/routes/add-funds/add-funds-hooks/use-clear-card-input-on-zero-wallet-funds.js", "JavaScript", 0, 31, 0, 0, 0, 0, 7, 38
"/Users/jonathanoakes/Desktop/breakfast-and-afterschool-club/src/routes/add-funds/add-funds-hooks/use-get-payment-result.js", "JavaScript", 0, 86, 0, 0, 0, 0, 15, 101
"/Users/jonathanoakes/Desktop/breakfast-and-afterschool-club/src/routes/add-funds/add-funds-hooks/use-handle-card-input-change.js", "JavaScript", 0, 35, 0, 0, 0, 0, 6, 41
"/Users/jonathanoakes/Desktop/breakfast-and-afterschool-club/src/routes/add-funds/add-funds-hooks/use-handle-wallet-funds-change.js", "JavaScript", 0, 19, 0, 0, 0, 0, 8, 27
"/Users/jonathanoakes/Desktop/breakfast-and-afterschool-club/src/routes/add-funds/add-funds-hooks/use-should-show-add-funds-button.component.js", "JavaScript", 0, 19, 0, 0, 0, 0, 7, 26
"/Users/jonathanoakes/Desktop/breakfast-and-afterschool-club/src/routes/add-funds/add-funds.component.jsx", "JavaScript", 0, 25, 0, 0, 0, 0, 8, 33
"/Users/jonathanoakes/Desktop/breakfast-and-afterschool-club/src/routes/add-funds/card-input-styles/card-input-styles.js", "JavaScript", 0, 20, 0, 0, 0, 0, 1, 21
"/Users/jonathanoakes/Desktop/breakfast-and-afterschool-club/src/routes/add-funds/card-input.component.jsx", "JavaScript", 0, 35, 0, 0, 0, 0, 10, 45
"/Users/jonathanoakes/Desktop/breakfast-and-afterschool-club/src/routes/add-funds/choose-wallet-funds-to-add.component.jsx", "JavaScript", 0, 27, 0, 0, 0, 0, 9, 36
"/Users/jonathanoakes/Desktop/breakfast-and-afterschool-club/src/routes/add-funds/errors-help-redirect/add-funds-error.component.jsx", "JavaScript", 0, 40, 0, 0, 0, 0, 7, 47
"/Users/jonathanoakes/Desktop/breakfast-and-afterschool-club/src/routes/add-funds/errors-help-redirect/add-funds-help.component.jsx", "JavaScript", 0, 56, 0, 0, 0, 0, 7, 63
"/Users/jonathanoakes/Desktop/breakfast-and-afterschool-club/src/routes/add-funds/errors-help-redirect/card-input-errors.component.jsx", "JavaScript", 0, 24, 0, 0, 0, 0, 8, 32
"/Users/jonathanoakes/Desktop/breakfast-and-afterschool-club/src/routes/add-funds/errors-help-redirect/redirect-and-loader.component.jsx", "JavaScript", 0, 21, 0, 0, 0, 0, 7, 28
"/Users/jonathanoakes/Desktop/breakfast-and-afterschool-club/src/routes/book-a-session/book-a-session-hooks/return-logic-and-reset-state/use-reset-state-and-navigate.js", "JavaScript", 0, 19, 0, 0, 0, 0, 6, 25
"/Users/jonathanoakes/Desktop/breakfast-and-afterschool-club/src/routes/book-a-session/book-a-session-hooks/return-logic-and-reset-state/use-return-logic.js", "JavaScript", 0, 37, 0, 0, 0, 0, 9, 46
"/Users/jonathanoakes/Desktop/breakfast-and-afterschool-club/src/routes/book-a-session/book-a-session-hooks/swals/use-get-book-session-result-swal.js", "JavaScript", 0, 46, 0, 0, 0, 0, 9, 55
"/Users/jonathanoakes/Desktop/breakfast-and-afterschool-club/src/routes/book-a-session/book-a-session-hooks/swals/use-success-swal.js", "JavaScript", 0, 27, 0, 0, 0, 0, 6, 33
"/Users/jonathanoakes/Desktop/breakfast-and-afterschool-club/src/routes/book-a-session/book-a-session-hooks/swals/use-update-balance-error-reset-session-doc-swal.js", "JavaScript", 0, 60, 0, 0, 0, 0, 10, 70
"/Users/jonathanoakes/Desktop/breakfast-and-afterschool-club/src/routes/book-a-session/book-a-session-hooks/swals/use-update-session-doc-error-swal.js", "JavaScript", 0, 53, 0, 0, 0, 0, 9, 62
"/Users/jonathanoakes/Desktop/breakfast-and-afterschool-club/src/routes/book-a-session/book-a-session-hooks/use-choose-date-handle-change.js", "JavaScript", 0, 10, 0, 0, 0, 0, 6, 16
"/Users/jonathanoakes/Desktop/breakfast-and-afterschool-club/src/routes/book-a-session/book-a-session-hooks/use-conditional-logic.js", "JavaScript", 0, 181, 0, 0, 0, 0, 29, 210
"/Users/jonathanoakes/Desktop/breakfast-and-afterschool-club/src/routes/book-a-session/book-a-session-hooks/use-confirm-session.js", "JavaScript", 0, 57, 0, 0, 0, 0, 14, 71
"/Users/jonathanoakes/Desktop/breakfast-and-afterschool-club/src/routes/book-a-session/book-a-session-hooks/use-get-date-and-time.js", "JavaScript", 0, 32, 0, 0, 0, 0, 12, 44
"/Users/jonathanoakes/Desktop/breakfast-and-afterschool-club/src/routes/book-a-session/book-a-session-hooks/use-get-session-prices.js", "JavaScript", 0, 10, 0, 0, 0, 0, 5, 15
"/Users/jonathanoakes/Desktop/breakfast-and-afterschool-club/src/routes/book-a-session/book-a-session-hooks/use-request-date-data.js", "JavaScript", 0, 13, 0, 0, 0, 0, 5, 18
"/Users/jonathanoakes/Desktop/breakfast-and-afterschool-club/src/routes/book-a-session/book-a-session.component.jsx", "JavaScript", 0, 38, 0, 0, 0, 0, 8, 46
"/Users/jonathanoakes/Desktop/breakfast-and-afterschool-club/src/routes/book-a-session/sections/balance-check-and-book-session-help.component.jsx", "JavaScript", 0, 75, 0, 0, 0, 0, 11, 86
"/Users/jonathanoakes/Desktop/breakfast-and-afterschool-club/src/routes/book-a-session/sections/buttons/afternoon-session-long-button.component.jsx", "JavaScript", 0, 35, 0, 0, 0, 0, 11, 46
"/Users/jonathanoakes/Desktop/breakfast-and-afterschool-club/src/routes/book-a-session/sections/buttons/afternoon-session-short-button.component.jsx", "JavaScript", 0, 31, 0, 0, 0, 0, 9, 40
"/Users/jonathanoakes/Desktop/breakfast-and-afterschool-club/src/routes/book-a-session/sections/buttons/morning-and-afternoon-session-long-button.component.jsx", "JavaScript", 0, 33, 0, 0, 0, 0, 10, 43
"/Users/jonathanoakes/Desktop/breakfast-and-afterschool-club/src/routes/book-a-session/sections/buttons/morning-and-afternoon-session-short-button.component.jsx", "JavaScript", 0, 33, 0, 0, 0, 0, 10, 43
"/Users/jonathanoakes/Desktop/breakfast-and-afterschool-club/src/routes/book-a-session/sections/buttons/morning-session-button.component.jsx", "JavaScript", 0, 31, 0, 0, 0, 0, 9, 40
"/Users/jonathanoakes/Desktop/breakfast-and-afterschool-club/src/routes/book-a-session/sections/choose-date.component.jsx", "JavaScript", 0, 36, 0, 0, 0, 0, 9, 45
"/Users/jonathanoakes/Desktop/breakfast-and-afterschool-club/src/routes/book-a-session/sections/choose-sessions.component.jsx", "JavaScript", 0, 72, 0, 0, 0, 0, 11, 83
"/Users/jonathanoakes/Desktop/breakfast-and-afterschool-club/src/routes/book-a-session/sections/date-errors.component.jsx", "JavaScript", 0, 33, 0, 0, 0, 0, 5, 38
"/Users/jonathanoakes/Desktop/breakfast-and-afterschool-club/src/routes/book-a-session/sections/error-fetching-prices.component.jsx", "JavaScript", 0, 25, 0, 0, 0, 0, 6, 31
"/Users/jonathanoakes/Desktop/breakfast-and-afterschool-club/src/routes/book-a-session/sections/heading-times-and-prices-wallet-balance-options-info.component.jsx", "JavaScript", 0, 19, 0, 0, 0, 0, 4, 23
"/Users/jonathanoakes/Desktop/breakfast-and-afterschool-club/src/routes/book-a-session/sections/loaders.component.jsx", "JavaScript", 0, 20, 0, 0, 0, 0, 6, 26
"/Users/jonathanoakes/Desktop/breakfast-and-afterschool-club/src/routes/book-a-session/sections/options-available-info.component.jsx", "JavaScript", 0, 25, 0, 0, 0, 0, 7, 32
"/Users/jonathanoakes/Desktop/breakfast-and-afterschool-club/src/routes/book-a-session/sections/select-children-to-book-session-for.component.jsx", "JavaScript", 0, 56, 0, 0, 0, 0, 12, 68
"/Users/jonathanoakes/Desktop/breakfast-and-afterschool-club/src/routes/book-a-session/sections/spaces-available-info.component.jsx", "JavaScript", 0, 19, 0, 0, 0, 0, 5, 24
"/Users/jonathanoakes/Desktop/breakfast-and-afterschool-club/src/routes/book-a-session/sections/times-and-prices-accordion.component.jsx", "JavaScript", 0, 95, 0, 0, 0, 1, 9, 105
"/Users/jonathanoakes/Desktop/breakfast-and-afterschool-club/src/routes/child-info/child-info-accordion.component.jsx", "JavaScript", 0, 58, 0, 0, 0, 0, 7, 65
"/Users/jonathanoakes/Desktop/breakfast-and-afterschool-club/src/routes/child-info/child-info-hooks/use-get-users-children-error-swal.js", "JavaScript", 0, 30, 0, 0, 0, 0, 8, 38
"/Users/jonathanoakes/Desktop/breakfast-and-afterschool-club/src/routes/child-info/child-info-hooks/use-get-users-children-listener.js", "JavaScript", 0, 30, 0, 0, 0, 1, 9, 40
"/Users/jonathanoakes/Desktop/breakfast-and-afterschool-club/src/routes/child-info/child-info-hooks/use-get-users-children.js", "JavaScript", 0, 13, 0, 0, 0, 0, 8, 21
"/Users/jonathanoakes/Desktop/breakfast-and-afterschool-club/src/routes/child-info/child-info.component.jsx", "JavaScript", 0, 32, 0, 0, 0, 0, 13, 45
"/Users/jonathanoakes/Desktop/breakfast-and-afterschool-club/src/routes/child-info/child-table.component.jsx", "JavaScript", 0, 95, 0, 0, 0, 0, 16, 111
"/Users/jonathanoakes/Desktop/breakfast-and-afterschool-club/src/routes/child-info/edit-remove-buttons.component.jsx", "JavaScript", 0, 47, 0, 0, 0, 0, 8, 55
"/Users/jonathanoakes/Desktop/breakfast-and-afterschool-club/src/routes/child-info/table-columns.js", "JavaScript", 0, 22, 0, 0, 0, 0, 1, 23
"/Users/jonathanoakes/Desktop/breakfast-and-afterschool-club/src/routes/close-account/close-account-hooks/use-account-closure-email.js", "JavaScript", 0, 19, 0, 0, 0, 0, 15, 34
"/Users/jonathanoakes/Desktop/breakfast-and-afterschool-club/src/routes/close-account/close-account-hooks/use-close-account-swal.js", "JavaScript", 0, 64, 0, 0, 0, 0, 9, 73
"/Users/jonathanoakes/Desktop/breakfast-and-afterschool-club/src/routes/close-account/close-account-hooks/use-confirm-close-account.js", "JavaScript", 0, 44, 0, 0, 0, 0, 11, 55
"/Users/jonathanoakes/Desktop/breakfast-and-afterschool-club/src/routes/close-account/close-account.component.jsx", "JavaScript", 0, 58, 0, 0, 0, 0, 12, 70
"/Users/jonathanoakes/Desktop/breakfast-and-afterschool-club/src/routes/contact/contact-form-hooks/use-confirm-send-contact-form-message.js", "JavaScript", 0, 35, 0, 0, 0, 0, 11, 46
"/Users/jonathanoakes/Desktop/breakfast-and-afterschool-club/src/routes/contact/contact-form-hooks/use-handle-contact-form-details-change.js", "JavaScript", 0, 13, 0, 0, 0, 0, 6, 19
"/Users/jonathanoakes/Desktop/breakfast-and-afterschool-club/src/routes/contact/contact-form-hooks/use-send-contact-form-message-result-swal.js", "JavaScript", 0, 53, 0, 0, 0, 0, 7, 60
"/Users/jonathanoakes/Desktop/breakfast-and-afterschool-club/src/routes/contact/contact.component.jsx", "JavaScript", 0, 22, 0, 0, 0, 0, 11, 33
"/Users/jonathanoakes/Desktop/breakfast-and-afterschool-club/src/routes/contact/sections/contact-form.component.jsx", "JavaScript", 0, 58, 0, 0, 0, 0, 14, 72
"/Users/jonathanoakes/Desktop/breakfast-and-afterschool-club/src/routes/contact/sections/send-message-button.component.jsx", "JavaScript", 0, 36, 0, 0, 0, 0, 10, 46
"/Users/jonathanoakes/Desktop/breakfast-and-afterschool-club/src/routes/dashboard/2023-24-dates/23-24-dates.js", "JavaScript", 0, 952, 0, 0, 0, 0, 1, 953
"/Users/jonathanoakes/Desktop/breakfast-and-afterschool-club/src/routes/dashboard/dashboard-hooks/use-confirm-upload-dates-to-database.js", "JavaScript", 0, 24, 0, 0, 0, 0, 11, 35
"/Users/jonathanoakes/Desktop/breakfast-and-afterschool-club/src/routes/dashboard/dashboard-hooks/use-upload-dates-to-database-swal.js", "JavaScript", 0, 39, 0, 0, 0, 0, 8, 47
"/Users/jonathanoakes/Desktop/breakfast-and-afterschool-club/src/routes/dashboard/dashboard.component.jsx", "JavaScript", 0, 17, 0, 0, 0, 0, 4, 21
"/Users/jonathanoakes/Desktop/breakfast-and-afterschool-club/src/routes/delete-child-info/delete-and-return-buttons.component.jsx", "JavaScript", 0, 21, 0, 0, 0, 0, 7, 28
"/Users/jonathanoakes/Desktop/breakfast-and-afterschool-club/src/routes/delete-child-info/delete-child-info.component.jsx", "JavaScript", 0, 14, 0, 0, 0, 0, 6, 20
"/Users/jonathanoakes/Desktop/breakfast-and-afterschool-club/src/routes/delete-child-info/hooks/use-confirm-delete-child-info.js", "JavaScript", 0, 21, 0, 0, 0, 0, 11, 32
"/Users/jonathanoakes/Desktop/breakfast-and-afterschool-club/src/routes/delete-child-info/hooks/use-delete-child-info-result-swal.js", "JavaScript", 0, 54, 0, 0, 0, 0, 10, 64
"/Users/jonathanoakes/Desktop/breakfast-and-afterschool-club/src/routes/delete-child-info/loader-title-info.component.jsx", "JavaScript", 0, 28, 0, 0, 0, 0, 10, 38
"/Users/jonathanoakes/Desktop/breakfast-and-afterschool-club/src/routes/edit-child-info/edit-and-return-buttons.component.jsx", "JavaScript", 0, 23, 0, 0, 0, 0, 6, 29
"/Users/jonathanoakes/Desktop/breakfast-and-afterschool-club/src/routes/edit-child-info/edit-child-info-form.component.jsx", "JavaScript", 0, 71, 0, 0, 0, 0, 13, 84
"/Users/jonathanoakes/Desktop/breakfast-and-afterschool-club/src/routes/edit-child-info/edit-child-info.component.jsx", "JavaScript", 0, 24, 0, 0, 0, 0, 10, 34
"/Users/jonathanoakes/Desktop/breakfast-and-afterschool-club/src/routes/edit-child-info/hooks/use-confirm-update-child-info.js", "JavaScript", 0, 52, 0, 0, 0, 0, 14, 66
"/Users/jonathanoakes/Desktop/breakfast-and-afterschool-club/src/routes/edit-child-info/hooks/use-edit-child-info-result-swal.js", "JavaScript", 0, 54, 0, 0, 0, 0, 10, 64
"/Users/jonathanoakes/Desktop/breakfast-and-afterschool-club/src/routes/edit-child-info/hooks/use-handle-updated-child-info-change.js", "JavaScript", 0, 22, 0, 0, 0, 0, 7, 29
"/Users/jonathanoakes/Desktop/breakfast-and-afterschool-club/src/routes/edit-child-info/hooks/use-prevent-show-if-no-data.js", "JavaScript", 0, 15, 0, 0, 0, 0, 6, 21
"/Users/jonathanoakes/Desktop/breakfast-and-afterschool-club/src/routes/forgot-password-request/forgot-password-request-hooks/use-forgot-password-request-swal.js", "JavaScript", 0, 60, 0, 0, 0, 0, 9, 69
"/Users/jonathanoakes/Desktop/breakfast-and-afterschool-club/src/routes/forgot-password-request/forgot-password-request-hooks/use-handle-forgot-password-request-email-change.js", "JavaScript", 0, 10, 0, 0, 0, 0, 6, 16
"/Users/jonathanoakes/Desktop/breakfast-and-afterschool-club/src/routes/forgot-password-request/forgot-password-request.component.jsx", "JavaScript", 0, 68, 0, 0, 0, 0, 14, 82
"/Users/jonathanoakes/Desktop/breakfast-and-afterschool-club/src/routes/forgot-password-result/forgot-password-result-hooks/use-confirm-reset-password.js", "JavaScript", 0, 43, 0, 0, 0, 0, 10, 53
"/Users/jonathanoakes/Desktop/breakfast-and-afterschool-club/src/routes/forgot-password-result/forgot-password-result-hooks/use-forgot-password-result-swal.js", "JavaScript", 0, 54, 0, 0, 0, 0, 11, 65
"/Users/jonathanoakes/Desktop/breakfast-and-afterschool-club/src/routes/forgot-password-result/forgot-password-result-hooks/use-handle-reset-password-form-change.js", "JavaScript", 0, 13, 0, 0, 0, 0, 6, 19
"/Users/jonathanoakes/Desktop/breakfast-and-afterschool-club/src/routes/forgot-password-result/forgot-password-result-hooks/use-hide-reset-password-fields-on-empty.js", "JavaScript", 0, 37, 0, 0, 0, 0, 6, 43
"/Users/jonathanoakes/Desktop/breakfast-and-afterschool-club/src/routes/forgot-password-result/forgot-password-result.component.jsx", "JavaScript", 0, 27, 0, 0, 0, 0, 11, 38
"/Users/jonathanoakes/Desktop/breakfast-and-afterschool-club/src/routes/forgot-password-result/sections/intro.component.jsx", "JavaScript", 0, 20, 0, 0, 0, 0, 5, 25
"/Users/jonathanoakes/Desktop/breakfast-and-afterschool-club/src/routes/forgot-password-result/sections/new-passwords.component.jsx", "JavaScript", 0, 74, 0, 0, 0, 0, 13, 87
"/Users/jonathanoakes/Desktop/breakfast-and-afterschool-club/src/routes/forgot-password-result/sections/reset-password-button.component.jsx", "JavaScript", 0, 29, 0, 0, 0, 0, 9, 38
"/Users/jonathanoakes/Desktop/breakfast-and-afterschool-club/src/routes/home/home.component.jsx", "JavaScript", 0, 12, 0, 0, 0, 0, 4, 16
"/Users/jonathanoakes/Desktop/breakfast-and-afterschool-club/src/routes/home/info.component.jsx", "JavaScript", 0, 21, 0, 0, 0, 0, 3, 24
"/Users/jonathanoakes/Desktop/breakfast-and-afterschool-club/src/routes/home/intro.component.jsx", "JavaScript", 0, 19, 0, 0, 0, 0, 4, 23
"/Users/jonathanoakes/Desktop/breakfast-and-afterschool-club/src/routes/home/links.component.jsx", "JavaScript", 0, 25, 0, 0, 0, 0, 5, 30
"/Users/jonathanoakes/Desktop/breakfast-and-afterschool-club/src/routes/magic-url-request/magic-url-request-hooks/use-confirm-request-magic-url.js", "JavaScript", 0, 26, 0, 0, 0, 0, 9, 35
"/Users/jonathanoakes/Desktop/breakfast-and-afterschool-club/src/routes/magic-url-request/magic-url-request-hooks/use-handle-magic-url-email-change.js", "JavaScript", 0, 10, 0, 0, 0, 0, 6, 16
"/Users/jonathanoakes/Desktop/breakfast-and-afterschool-club/src/routes/magic-url-request/magic-url-request-hooks/use-magic-url-request-swal.js", "JavaScript", 0, 48, 0, 0, 0, 0, 9, 57
"/Users/jonathanoakes/Desktop/breakfast-and-afterschool-club/src/routes/magic-url-request/magic-url-request-info.component.jsx", "JavaScript", 0, 97, 0, 0, 0, 0, 7, 104
"/Users/jonathanoakes/Desktop/breakfast-and-afterschool-club/src/routes/magic-url-request/magic-url-request.component.jsx", "JavaScript", 0, 53, 0, 0, 0, 0, 13, 66
"/Users/jonathanoakes/Desktop/breakfast-and-afterschool-club/src/routes/magic-url-result/magic-url-result.component.jsx", "JavaScript", 0, 69, 0, 0, 0, 0, 13, 82
"/Users/jonathanoakes/Desktop/breakfast-and-afterschool-club/src/routes/magic-url-result/use-get-magic-url-result.js", "JavaScript", 0, 14, 0, 0, 0, 0, 5, 19
"/Users/jonathanoakes/Desktop/breakfast-and-afterschool-club/src/routes/navigation/nav-app-owner.component.jsx", "JavaScript", 0, 33, 0, 0, 0, 0, 9, 42
"/Users/jonathanoakes/Desktop/breakfast-and-afterschool-club/src/routes/navigation/nav-hamburger.component.jsx", "JavaScript", 0, 36, 0, 0, 0, 0, 6, 42
"/Users/jonathanoakes/Desktop/breakfast-and-afterschool-club/src/routes/navigation/nav-logo.component.jsx", "JavaScript", 0, 17, 0, 0, 0, 0, 6, 23
"/Users/jonathanoakes/Desktop/breakfast-and-afterschool-club/src/routes/navigation/nav-no-user.component.jsx", "JavaScript", 0, 33, 0, 0, 0, 0, 9, 42
"/Users/jonathanoakes/Desktop/breakfast-and-afterschool-club/src/routes/navigation/nav-not-app-owner.component.jsx", "JavaScript", 0, 66, 0, 0, 0, 0, 11, 77
"/Users/jonathanoakes/Desktop/breakfast-and-afterschool-club/src/routes/navigation/nav-sign-out.component.jsx", "JavaScript", 0, 59, 0, 0, 0, 0, 13, 72
"/Users/jonathanoakes/Desktop/breakfast-and-afterschool-club/src/routes/navigation/navigation-hooks/use-get-sign-out-error.js", "JavaScript", 0, 35, 0, 0, 0, 0, 10, 45
"/Users/jonathanoakes/Desktop/breakfast-and-afterschool-club/src/routes/navigation/navigation.component.jsx", "JavaScript", 0, 50, 0, 0, 0, 0, 10, 60
"/Users/jonathanoakes/Desktop/breakfast-and-afterschool-club/src/routes/navigation/routes.js", "JavaScript", 0, 27, 0, 0, 0, 0, 4, 31
"/Users/jonathanoakes/Desktop/breakfast-and-afterschool-club/src/routes/payment-result/payment-result-hooks/use-get-upload-result.js", "JavaScript", 0, 75, 0, 0, 0, 0, 13, 88
"/Users/jonathanoakes/Desktop/breakfast-and-afterschool-club/src/routes/payment-result/payment-result-hooks/use-handle-payment-failed.js", "JavaScript", 0, 37, 0, 0, 0, 0, 9, 46
"/Users/jonathanoakes/Desktop/breakfast-and-afterschool-club/src/routes/payment-result/payment-result-hooks/use-handle-payment-succeeded.js", "JavaScript", 0, 41, 0, 0, 0, 0, 8, 49
"/Users/jonathanoakes/Desktop/breakfast-and-afterschool-club/src/routes/payment-result/payment-result.component.jsx", "JavaScript", 0, 24, 0, 0, 0, 0, 11, 35
"/Users/jonathanoakes/Desktop/breakfast-and-afterschool-club/src/routes/sign-in/sections/sign-in-button.component.jsx", "JavaScript", 0, 30, 0, 0, 0, 0, 8, 38
"/Users/jonathanoakes/Desktop/breakfast-and-afterschool-club/src/routes/sign-in/sections/sign-in-email.component.jsx", "JavaScript", 0, 20, 0, 0, 0, 0, 7, 27
"/Users/jonathanoakes/Desktop/breakfast-and-afterschool-club/src/routes/sign-in/sections/sign-in-password.component.jsx", "JavaScript", 0, 36, 0, 0, 0, 0, 11, 47
"/Users/jonathanoakes/Desktop/breakfast-and-afterschool-club/src/routes/sign-in/sign-in-form-hooks/use-handle-sign-in-form-change.js", "JavaScript", 0, 13, 0, 0, 0, 0, 6, 19
"/Users/jonathanoakes/Desktop/breakfast-and-afterschool-club/src/routes/sign-in/sign-in-form-hooks/use-handle-sign-in-form-error.js", "JavaScript", 0, 20, 0, 0, 0, 0, 8, 28
"/Users/jonathanoakes/Desktop/breakfast-and-afterschool-club/src/routes/sign-in/sign-in-form-hooks/use-handle-sign-in-form-submit.js", "JavaScript", 0, 26, 0, 0, 0, 0, 10, 36
"/Users/jonathanoakes/Desktop/breakfast-and-afterschool-club/src/routes/sign-in/sign-in-form-hooks/use-hide-sign-in-password-on-empty.js", "JavaScript", 0, 17, 0, 0, 0, 0, 8, 25
"/Users/jonathanoakes/Desktop/breakfast-and-afterschool-club/src/routes/sign-in/sign-in.component.jsx", "JavaScript", 0, 53, 0, 0, 0, 0, 13, 66
"/Users/jonathanoakes/Desktop/breakfast-and-afterschool-club/src/routes/sign-up/sections/sign-up-button.component.jsx", "JavaScript", 0, 25, 0, 0, 0, 0, 5, 30
"/Users/jonathanoakes/Desktop/breakfast-and-afterschool-club/src/routes/sign-up/sections/sign-up-email.component.jsx", "JavaScript", 0, 16, 0, 0, 0, 0, 3, 19
"/Users/jonathanoakes/Desktop/breakfast-and-afterschool-club/src/routes/sign-up/sections/sign-up-name.component.jsx", "JavaScript", 0, 16, 0, 0, 0, 0, 3, 19
"/Users/jonathanoakes/Desktop/breakfast-and-afterschool-club/src/routes/sign-up/sections/sign-up-passwords.component.jsx", "JavaScript", 0, 73, 0, 0, 0, 0, 13, 86
"/Users/jonathanoakes/Desktop/breakfast-and-afterschool-club/src/routes/sign-up/sign-up-form-hooks/use-handle-sign-up-form-change.js", "JavaScript", 0, 13, 0, 0, 0, 0, 6, 19
"/Users/jonathanoakes/Desktop/breakfast-and-afterschool-club/src/routes/sign-up/sign-up-form-hooks/use-handle-sign-up-form-error.js", "JavaScript", 0, 20, 0, 0, 0, 0, 7, 27
"/Users/jonathanoakes/Desktop/breakfast-and-afterschool-club/src/routes/sign-up/sign-up-form-hooks/use-handle-sign-up-form-submit.js", "JavaScript", 0, 29, 0, 0, 0, 0, 10, 39
"/Users/jonathanoakes/Desktop/breakfast-and-afterschool-club/src/routes/sign-up/sign-up-form-hooks/use-hide-sign-up-password-on-empty.js", "JavaScript", 0, 34, 0, 0, 0, 0, 7, 41
"/Users/jonathanoakes/Desktop/breakfast-and-afterschool-club/src/routes/sign-up/sign-up.component.jsx", "JavaScript", 0, 59, 0, 0, 0, 0, 13, 72
"/Users/jonathanoakes/Desktop/breakfast-and-afterschool-club/src/routes/social-login-result/navigate-and-loader.component.jsx", "JavaScript", 0, 19, 0, 0, 0, 0, 7, 26
"/Users/jonathanoakes/Desktop/breakfast-and-afterschool-club/src/routes/social-login-result/social-login-error.component.jsx", "JavaScript", 0, 56, 0, 0, 0, 0, 19, 75
"/Users/jonathanoakes/Desktop/breakfast-and-afterschool-club/src/routes/social-login-result/social-login-hooks/use-nav-and-reset-error.js", "JavaScript", 0, 26, 0, 0, 0, 0, 8, 34
"/Users/jonathanoakes/Desktop/breakfast-and-afterschool-club/src/routes/social-login-result/social-login-result.component.jsx", "JavaScript", 0, 17, 0, 0, 0, 0, 4, 21
"/Users/jonathanoakes/Desktop/breakfast-and-afterschool-club/src/routes/social-login-result/social-login-success.component.jsx", "JavaScript", 0, 18, 0, 0, 0, 0, 6, 24
"/Users/jonathanoakes/Desktop/breakfast-and-afterschool-club/src/routes/update-email/info.component.jsx", "JavaScript", 0, 55, 0, 0, 0, 0, 8, 63
"/Users/jonathanoakes/Desktop/breakfast-and-afterschool-club/src/routes/update-email/new-email.component.jsx", "JavaScript", 0, 74, 0, 0, 0, 0, 13, 87
"/Users/jonathanoakes/Desktop/breakfast-and-afterschool-club/src/routes/update-email/title-and-loader.component.jsx", "JavaScript", 0, 20, 0, 0, 0, 0, 7, 27
"/Users/jonathanoakes/Desktop/breakfast-and-afterschool-club/src/routes/update-email/update-email-hooks/use-confirm-update-email.js", "JavaScript", 0, 49, 0, 0, 0, 0, 12, 61
"/Users/jonathanoakes/Desktop/breakfast-and-afterschool-club/src/routes/update-email/update-email-hooks/use-handle-update-email-details.js", "JavaScript", 0, 13, 0, 0, 0, 0, 6, 19
"/Users/jonathanoakes/Desktop/breakfast-and-afterschool-club/src/routes/update-email/update-email-hooks/use-hide-update-email-password-on-empty.js", "JavaScript", 0, 19, 0, 0, 0, 0, 7, 26
"/Users/jonathanoakes/Desktop/breakfast-and-afterschool-club/src/routes/update-email/update-email-hooks/use-update-email-result-swal.js", "JavaScript", 0, 73, 0, 0, 0, 0, 10, 83
"/Users/jonathanoakes/Desktop/breakfast-and-afterschool-club/src/routes/update-email/update-email.component.jsx", "JavaScript", 0, 19, 0, 0, 0, 0, 7, 26
"/Users/jonathanoakes/Desktop/breakfast-and-afterschool-club/src/routes/update-password-request/info.component.jsx", "JavaScript", 0, 52, 0, 0, 0, 0, 8, 60
"/Users/jonathanoakes/Desktop/breakfast-and-afterschool-club/src/routes/update-password-request/title-and-loader.component.jsx", "JavaScript", 0, 20, 0, 0, 0, 0, 7, 27
"/Users/jonathanoakes/Desktop/breakfast-and-afterschool-club/src/routes/update-password-request/update-password-request-button.component.jsx", "JavaScript", 0, 48, 0, 0, 0, 0, 13, 61
"/Users/jonathanoakes/Desktop/breakfast-and-afterschool-club/src/routes/update-password-request/update-password-request-hooks/use-confirm-update-password-request.js", "JavaScript", 0, 27, 0, 0, 0, 0, 11, 38
"/Users/jonathanoakes/Desktop/breakfast-and-afterschool-club/src/routes/update-password-request/update-password-request-hooks/use-update-password-request-result-swal.js", "JavaScript", 0, 53, 0, 0, 0, 0, 10, 63
"/Users/jonathanoakes/Desktop/breakfast-and-afterschool-club/src/routes/update-password-request/update-password-request.component.jsx", "JavaScript", 0, 19, 0, 0, 0, 0, 6, 25
"/Users/jonathanoakes/Desktop/breakfast-and-afterschool-club/src/routes/update-password-result/new-passwords.component.jsx", "JavaScript", 0, 73, 0, 0, 0, 0, 13, 86
"/Users/jonathanoakes/Desktop/breakfast-and-afterschool-club/src/routes/update-password-result/title-loader-info.component.jsx", "JavaScript", 0, 25, 0, 0, 0, 0, 8, 33
"/Users/jonathanoakes/Desktop/breakfast-and-afterschool-club/src/routes/update-password-result/update-password-button.component.jsx", "JavaScript", 0, 32, 0, 0, 0, 0, 9, 41
"/Users/jonathanoakes/Desktop/breakfast-and-afterschool-club/src/routes/update-password-result/update-password-result-hooks/use-confirm-update-password.js", "JavaScript", 0, 55, 0, 0, 0, 0, 12, 67
"/Users/jonathanoakes/Desktop/breakfast-and-afterschool-club/src/routes/update-password-result/update-password-result-hooks/use-handle-update-password-form-change.js", "JavaScript", 0, 15, 0, 0, 0, 0, 6, 21
"/Users/jonathanoakes/Desktop/breakfast-and-afterschool-club/src/routes/update-password-result/update-password-result-hooks/use-hide-update-password-field-on-empty.js", "JavaScript", 0, 38, 0, 0, 0, 0, 6, 44
"/Users/jonathanoakes/Desktop/breakfast-and-afterschool-club/src/routes/update-password-result/update-password-result-hooks/use-update-password-result-swal.js", "JavaScript", 0, 79, 0, 0, 0, 0, 11, 90
"/Users/jonathanoakes/Desktop/breakfast-and-afterschool-club/src/routes/update-password-result/update-password-result.component.jsx", "JavaScript", 0, 22, 0, 0, 0, 0, 6, 28
"/Users/jonathanoakes/Desktop/breakfast-and-afterschool-club/src/service-worker.js", "JavaScript", 0, 38, 0, 0, 0, 24, 12, 74
"/Users/jonathanoakes/Desktop/breakfast-and-afterschool-club/src/serviceWorkerRegistration.js", "JavaScript", 0, 101, 0, 0, 0, 22, 10, 133
"/Users/jonathanoakes/Desktop/breakfast-and-afterschool-club/src/store/add-child-info/add-child-info.selector.js", "JavaScript", 0, 18, 0, 0, 0, 0, 5, 23
"/Users/jonathanoakes/Desktop/breakfast-and-afterschool-club/src/store/add-child-info/add-child-info.slice.js", "JavaScript", 0, 84, 0, 0, 0, 0, 9, 93
"/Users/jonathanoakes/Desktop/breakfast-and-afterschool-club/src/store/book-session/book-session-thunks.js", "JavaScript", 0, 136, 0, 0, 0, 0, 17, 153
"/Users/jonathanoakes/Desktop/breakfast-and-afterschool-club/src/store/book-session/book-session.selector.js", "JavaScript", 0, 26, 0, 0, 0, 0, 8, 34
"/Users/jonathanoakes/Desktop/breakfast-and-afterschool-club/src/store/book-session/book-session.slice.js", "JavaScript", 0, 96, 0, 0, 0, 0, 8, 104
"/Users/jonathanoakes/Desktop/breakfast-and-afterschool-club/src/store/card-input-result/card-input-result.selector.js", "JavaScript", 0, 6, 0, 0, 0, 0, 3, 9
"/Users/jonathanoakes/Desktop/breakfast-and-afterschool-club/src/store/card-input-result/card-input-result.slice.js", "JavaScript", 0, 24, 0, 0, 0, 0, 5, 29
"/Users/jonathanoakes/Desktop/breakfast-and-afterschool-club/src/store/close-account/close-account.selector.js", "JavaScript", 0, 14, 0, 0, 0, 0, 5, 19
"/Users/jonathanoakes/Desktop/breakfast-and-afterschool-club/src/store/close-account/close-account.slice.js", "JavaScript", 0, 52, 0, 0, 0, 0, 7, 59
"/Users/jonathanoakes/Desktop/breakfast-and-afterschool-club/src/store/contact-form/contact-form.selector.js", "JavaScript", 0, 18, 0, 0, 0, 0, 6, 24
"/Users/jonathanoakes/Desktop/breakfast-and-afterschool-club/src/store/contact-form/contact-form.slice.js", "JavaScript", 0, 75, 0, 0, 0, 0, 8, 83
"/Users/jonathanoakes/Desktop/breakfast-and-afterschool-club/src/store/contact-form/email-to-send.js", "JavaScript", 0, 16, 0, 0, 0, 0, 5, 21
"/Users/jonathanoakes/Desktop/breakfast-and-afterschool-club/src/store/date-and-time/date-and-time.selector.js", "JavaScript", 0, 6, 0, 0, 0, 0, 3, 9
"/Users/jonathanoakes/Desktop/breakfast-and-afterschool-club/src/store/date-and-time/date-and-time.slice.js", "JavaScript", 0, 16, 0, 0, 0, 0, 5, 21
"/Users/jonathanoakes/Desktop/breakfast-and-afterschool-club/src/store/delete-child-info/delete-child-info.selector.js", "JavaScript", 0, 18, 0, 0, 0, 0, 6, 24
"/Users/jonathanoakes/Desktop/breakfast-and-afterschool-club/src/store/delete-child-info/delete-child-info.slice.js", "JavaScript", 0, 77, 0, 0, 0, 0, 10, 87
"/Users/jonathanoakes/Desktop/breakfast-and-afterschool-club/src/store/edit-child-info/edit-child-info.selector.js", "JavaScript", 0, 18, 0, 0, 0, 0, 6, 24
"/Users/jonathanoakes/Desktop/breakfast-and-afterschool-club/src/store/edit-child-info/edit-child-info.slice.js", "JavaScript", 0, 77, 0, 0, 0, 0, 10, 87
"/Users/jonathanoakes/Desktop/breakfast-and-afterschool-club/src/store/forgot-password-request/forgot-password-request.selector.js", "JavaScript", 0, 20, 0, 0, 0, 0, 6, 26
"/Users/jonathanoakes/Desktop/breakfast-and-afterschool-club/src/store/forgot-password-request/forgot-password-request.slice.js", "JavaScript", 0, 74, 0, 0, 0, 0, 7, 81
"/Users/jonathanoakes/Desktop/breakfast-and-afterschool-club/src/store/forgot-password-result/forgot-password-result.selector.js", "JavaScript", 0, 18, 0, 0, 0, 0, 6, 24
"/Users/jonathanoakes/Desktop/breakfast-and-afterschool-club/src/store/forgot-password-result/forgot-password-result.slice.js", "JavaScript", 0, 76, 0, 0, 0, 0, 8, 84
"/Users/jonathanoakes/Desktop/breakfast-and-afterschool-club/src/store/get-users-children/get-users-children-slice.js", "JavaScript", 0, 59, 0, 0, 0, 0, 8, 67
"/Users/jonathanoakes/Desktop/breakfast-and-afterschool-club/src/store/get-users-children/get-users-children.selector.js", "JavaScript", 0, 18, 0, 0, 0, 0, 6, 24
"/Users/jonathanoakes/Desktop/breakfast-and-afterschool-club/src/store/hamburger-menu/hamburger-menu.selector.js", "JavaScript", 0, 6, 0, 0, 0, 0, 3, 9
"/Users/jonathanoakes/Desktop/breakfast-and-afterschool-club/src/store/hamburger-menu/hamburger-menu.slice.js", "JavaScript", 0, 19, 0, 0, 0, 0, 5, 24
"/Users/jonathanoakes/Desktop/breakfast-and-afterschool-club/src/store/handle-payment/handle-payment.selector.js", "JavaScript", 0, 26, 0, 0, 0, 0, 8, 34
"/Users/jonathanoakes/Desktop/breakfast-and-afterschool-club/src/store/handle-payment/handle-payment.slice.js", "JavaScript", 0, 152, 0, 0, 0, 0, 13, 165
"/Users/jonathanoakes/Desktop/breakfast-and-afterschool-club/src/store/is-online/is-online.selector.js", "JavaScript", 0, 6, 0, 0, 0, 0, 3, 9
"/Users/jonathanoakes/Desktop/breakfast-and-afterschool-club/src/store/is-online/is-online.slice.js", "JavaScript", 0, 15, 0, 0, 0, 0, 5, 20
"/Users/jonathanoakes/Desktop/breakfast-and-afterschool-club/src/store/magic-url-request/magic-url-request.selector.js", "JavaScript", 0, 18, 0, 0, 0, 0, 6, 24
"/Users/jonathanoakes/Desktop/breakfast-and-afterschool-club/src/store/magic-url-request/magic-url-request.slice.js", "JavaScript", 0, 81, 0, 0, 0, 0, 7, 88
"/Users/jonathanoakes/Desktop/breakfast-and-afterschool-club/src/store/password-is-visible/password-is-visible.selector.js", "JavaScript", 0, 38, 0, 0, 0, 0, 10, 48
"/Users/jonathanoakes/Desktop/breakfast-and-afterschool-club/src/store/password-is-visible/password-is-visible.slice.js", "JavaScript", 0, 87, 0, 0, 0, 0, 5, 92
"/Users/jonathanoakes/Desktop/breakfast-and-afterschool-club/src/store/progressive-image/progressive-image.selector.js", "JavaScript", 0, 6, 0, 0, 0, 0, 3, 9
"/Users/jonathanoakes/Desktop/breakfast-and-afterschool-club/src/store/progressive-image/progressive-image.slice.js", "JavaScript", 0, 16, 0, 0, 0, 0, 6, 22
"/Users/jonathanoakes/Desktop/breakfast-and-afterschool-club/src/store/request-date-data/request-date-data.selector.js", "JavaScript", 0, 18, 0, 0, 0, 0, 6, 24
"/Users/jonathanoakes/Desktop/breakfast-and-afterschool-club/src/store/request-date-data/request-date-data.slice.js", "JavaScript", 0, 89, 0, 0, 0, 0, 8, 97
"/Users/jonathanoakes/Desktop/breakfast-and-afterschool-club/src/store/root-reducer.js", "JavaScript", 0, 59, 0, 0, 0, 0, 3, 62
"/Users/jonathanoakes/Desktop/breakfast-and-afterschool-club/src/store/session-types-and-prices/session-types-and-prices.selector.js", "JavaScript", 0, 71, 0, 0, 0, 0, 14, 85
"/Users/jonathanoakes/Desktop/breakfast-and-afterschool-club/src/store/session-types-and-prices/session-types-and-prices.slice.js", "JavaScript", 0, 63, 0, 0, 0, 0, 8, 71
"/Users/jonathanoakes/Desktop/breakfast-and-afterschool-club/src/store/should-show-element/should-show-element.selector.js", "JavaScript", 0, 10, 0, 0, 0, 0, 4, 14
"/Users/jonathanoakes/Desktop/breakfast-and-afterschool-club/src/store/should-show-element/should-show-element.slice.js", "JavaScript", 0, 43, 0, 0, 0, 0, 5, 48
"/Users/jonathanoakes/Desktop/breakfast-and-afterschool-club/src/store/sign-in-form/sign-in-form.selector.js", "JavaScript", 0, 6, 0, 0, 0, 0, 3, 9
"/Users/jonathanoakes/Desktop/breakfast-and-afterschool-club/src/store/sign-in-form/sign-in-form.slice.js", "JavaScript", 0, 23, 0, 0, 0, 0, 5, 28
"/Users/jonathanoakes/Desktop/breakfast-and-afterschool-club/src/store/sign-up-form/sign-up-form.selector.js", "JavaScript", 0, 6, 0, 0, 0, 0, 3, 9
"/Users/jonathanoakes/Desktop/breakfast-and-afterschool-club/src/store/sign-up-form/sign-up-form.slice.js", "JavaScript", 0, 25, 0, 0, 0, 0, 5, 30
"/Users/jonathanoakes/Desktop/breakfast-and-afterschool-club/src/store/store.js", "JavaScript", 0, 13, 0, 0, 0, 49, 12, 74
"/Users/jonathanoakes/Desktop/breakfast-and-afterschool-club/src/store/update-email/update-email.selector.js", "JavaScript", 0, 18, 0, 0, 0, 0, 6, 24
"/Users/jonathanoakes/Desktop/breakfast-and-afterschool-club/src/store/update-email/update-email.slice.js", "JavaScript", 0, 64, 0, 0, 0, 0, 6, 70
"/Users/jonathanoakes/Desktop/breakfast-and-afterschool-club/src/store/update-password-request/update-password-request.selector.js", "JavaScript", 0, 15, 0, 0, 0, 0, 5, 20
"/Users/jonathanoakes/Desktop/breakfast-and-afterschool-club/src/store/update-password-request/update-password-request.slice.js", "JavaScript", 0, 59, 0, 0, 0, 0, 7, 66
"/Users/jonathanoakes/Desktop/breakfast-and-afterschool-club/src/store/update-password-result/update-password-result.selector.js", "JavaScript", 0, 18, 0, 0, 0, 0, 6, 24
"/Users/jonathanoakes/Desktop/breakfast-and-afterschool-club/src/store/update-password-result/update-password-result.slice.js", "JavaScript", 0, 76, 0, 0, 0, 0, 7, 83
"/Users/jonathanoakes/Desktop/breakfast-and-afterschool-club/src/store/upload-dates-to-database/upload-dates-to-database.selector.js", "JavaScript", 0, 15, 0, 0, 0, 0, 5, 20
"/Users/jonathanoakes/Desktop/breakfast-and-afterschool-club/src/store/upload-dates-to-database/upload-dates-to-database.slice.js", "JavaScript", 0, 61, 0, 0, 0, 0, 8, 69
"/Users/jonathanoakes/Desktop/breakfast-and-afterschool-club/src/store/user/functions.js", "JavaScript", 0, 54, 0, 0, 0, 0, 11, 65
"/Users/jonathanoakes/Desktop/breakfast-and-afterschool-club/src/store/user/user.actions.js", "JavaScript", 0, 132, 0, 0, 0, 0, 16, 148
"/Users/jonathanoakes/Desktop/breakfast-and-afterschool-club/src/store/user/user.selector.js", "JavaScript", 0, 14, 0, 0, 0, 3, 6, 23
"/Users/jonathanoakes/Desktop/breakfast-and-afterschool-club/src/store/user/user.slice.js", "JavaScript", 0, 122, 0, 0, 0, 0, 7, 129
"/Users/jonathanoakes/Desktop/breakfast-and-afterschool-club/src/store/wallet-funds-to-add/wallet-funds-to-add.selector.js", "JavaScript", 0, 6, 0, 0, 0, 0, 3, 9
"/Users/jonathanoakes/Desktop/breakfast-and-afterschool-club/src/store/wallet-funds-to-add/wallet-funds-to-add.slice.js", "JavaScript", 0, 19, 0, 0, 0, 0, 5, 24
"/Users/jonathanoakes/Desktop/breakfast-and-afterschool-club/src/strings/strings.js", "JavaScript", 0, 239, 0, 0, 0, 6, 7, 252
"/Users/jonathanoakes/Desktop/breakfast-and-afterschool-club/src/styles/buttons/buttons.styles.jsx", "JavaScript", 0, 151, 0, 0, 0, 0, 27, 178
"/Users/jonathanoakes/Desktop/breakfast-and-afterschool-club/src/styles/colors.js", "JavaScript", 0, 31, 0, 0, 0, 0, 1, 32
"/Users/jonathanoakes/Desktop/breakfast-and-afterschool-club/src/styles/confirm.css", "CSS", 0, 0, 31, 0, 0, 0, 6, 37
"/Users/jonathanoakes/Desktop/breakfast-and-afterschool-club/src/styles/container/container.styles.jsx", "JavaScript", 0, 13, 0, 0, 0, 0, 4, 17
"/Users/jonathanoakes/Desktop/breakfast-and-afterschool-club/src/styles/div/div.styles.jsx", "JavaScript", 0, 368, 0, 0, 0, 12, 67, 447
"/Users/jonathanoakes/Desktop/breakfast-and-afterschool-club/src/styles/form/form.styles.jsx", "JavaScript", 0, 369, 0, 0, 0, 7, 77, 453
"/Users/jonathanoakes/Desktop/breakfast-and-afterschool-club/src/styles/h1/h1.styles.jsx", "JavaScript", 0, 8, 0, 0, 0, 0, 3, 11
"/Users/jonathanoakes/Desktop/breakfast-and-afterschool-club/src/styles/h2/h2.styles.jsx", "JavaScript", 0, 6, 0, 0, 0, 0, 2, 8
"/Users/jonathanoakes/Desktop/breakfast-and-afterschool-club/src/styles/hr/hr.styles.jsx", "JavaScript", 0, 13, 0, 0, 0, 0, 4, 17
"/Users/jonathanoakes/Desktop/breakfast-and-afterschool-club/src/styles/image/image.styles.jsx", "JavaScript", 0, 64, 0, 0, 0, 0, 14, 78
"/Users/jonathanoakes/Desktop/breakfast-and-afterschool-club/src/styles/link/link.styles.jsx", "JavaScript", 0, 17, 0, 0, 0, 0, 6, 23
"/Users/jonathanoakes/Desktop/breakfast-and-afterschool-club/src/styles/p/p.styles.jsx", "JavaScript", 0, 34, 0, 0, 0, 0, 9, 43
"/Users/jonathanoakes/Desktop/breakfast-and-afterschool-club/src/styles/span/span.styles.jsx", "JavaScript", 0, 137, 0, 0, 0, 0, 24, 161
"/Users/jonathanoakes/Desktop/breakfast-and-afterschool-club/src/styles/svg/svg.styles.jsx", "JavaScript", 0, 28, 0, 0, 0, 0, 6, 34
"/Users/jonathanoakes/Desktop/breakfast-and-afterschool-club/src/styles/tables/tables.styles.jsx", "JavaScript", 0, 48, 0, 0, 0, 1, 9, 58
"/Users/jonathanoakes/Desktop/breakfast-and-afterschool-club/src/utils/appwrite/appwrite-config.js", "JavaScript", 0, 8, 0, 0, 0, 1, 5, 14
"/Users/jonathanoakes/Desktop/breakfast-and-afterschool-club/src/utils/stripe/stripe.utils.js", "JavaScript", 0, 4, 0, 0, 0, 0, 2, 6
"/Users/jonathanoakes/Desktop/breakfast-and-afterschool-club/vite.config.js", "JavaScript", 0, 18, 0, 0, 0, 12, 1, 31
"Total", "-", 222, 12849, 46, 83, 21, 280, 2444, 15945