"filename", "language", "HTML", "CSS", "JavaScript", "XML", "JSON", "comment", "blank", "total"
"c:\Users\Jonathan\Desktop\breakfast-and-after-school-club\index.html", "HTML", 21, 0, 0, 0, 0, 0, 1, 22
"c:\Users\Jonathan\Desktop\breakfast-and-after-school-club\netlify\api-endpoints\api-endpoints.js", "JavaScript", 0, 0, 24, 0, 0, 0, 1, 25
"c:\Users\Jonathan\Desktop\breakfast-and-after-school-club\netlify\functions\create-payment-intent.js", "JavaScript", 0, 0, 23, 0, 0, 0, 4, 27
"c:\Users\Jonathan\Desktop\breakfast-and-after-school-club\netlify\functions\send-contact-form-message.js", "JavaScript", 0, 0, 26, 0, 0, 0, 4, 30
"c:\Users\Jonathan\Desktop\breakfast-and-after-school-club\netlify\functions\send-email-balance-not-updated-error.js", "JavaScript", 0, 0, 25, 0, 0, 0, 4, 29
"c:\Users\Jonathan\Desktop\breakfast-and-after-school-club\netlify\functions\send-email-booking-cancellation-confirmation.js", "JavaScript", 0, 0, 37, 0, 0, 0, 4, 41
"c:\Users\Jonathan\Desktop\breakfast-and-after-school-club\netlify\functions\send-email-booking-confirmation.js", "JavaScript", 0, 0, 37, 0, 0, 0, 4, 41
"c:\Users\Jonathan\Desktop\breakfast-and-after-school-club\netlify\functions\send-email-booking-not-added-to-database.js", "JavaScript", 0, 0, 35, 0, 0, 0, 4, 39
"c:\Users\Jonathan\Desktop\breakfast-and-after-school-club\netlify\functions\send-email-reset-session-spaces-and-balance-error.js", "JavaScript", 0, 0, 35, 0, 0, 0, 4, 39
"c:\Users\Jonathan\Desktop\breakfast-and-after-school-club\netlify\functions\send-email-reset-session-spaces-error.js", "JavaScript", 0, 0, 29, 0, 0, 0, 4, 33
"c:\Users\Jonathan\Desktop\breakfast-and-after-school-club\netlify\functions\send-email-to-admin-close-account-request.js", "JavaScript", 0, 0, 26, 0, 0, 0, 4, 30
"c:\Users\Jonathan\Desktop\breakfast-and-after-school-club\netlify\functions\send-email-wallet-funds-not-added-error.js", "JavaScript", 0, 0, 25, 0, 0, 0, 4, 29
"c:\Users\Jonathan\Desktop\breakfast-and-after-school-club\package.json", "JSON", 0, 0, 0, 0, 53, 0, 1, 54
"c:\Users\Jonathan\Desktop\breakfast-and-after-school-club\public\manifest.json", "JSON", 0, 0, 0, 0, 32, 0, 1, 33
"c:\Users\Jonathan\Desktop\breakfast-and-after-school-club\src\App.css", "CSS", 0, 3, 0, 0, 0, 0, 1, 4
"c:\Users\Jonathan\Desktop\breakfast-and-after-school-club\src\App.jsx", "JavaScript", 0, 0, 168, 0, 0, 0, 17, 185
"c:\Users\Jonathan\Desktop\breakfast-and-after-school-club\src\assets\arrow-left-1.svg", "XML", 0, 0, 0, 16, 0, 0, 0, 16
"c:\Users\Jonathan\Desktop\breakfast-and-after-school-club\src\assets\crayons.svg", "XML", 0, 0, 0, 152, 0, 0, 1, 153
"c:\Users\Jonathan\Desktop\breakfast-and-after-school-club\src\assets\loader.svg", "XML", 0, 0, 0, 8, 0, 0, 0, 8
"c:\Users\Jonathan\Desktop\breakfast-and-after-school-club\src\assets\pencil.svg", "XML", 0, 0, 0, 45, 0, 0, 1, 46
"c:\Users\Jonathan\Desktop\breakfast-and-after-school-club\src\assets\stripe-logo.svg", "XML", 0, 0, 0, 1, 0, 4, 0, 5
"c:\Users\Jonathan\Desktop\breakfast-and-after-school-club\src\components\custom-button\custom-button.component.jsx", "JavaScript", 0, 0, 5, 0, 0, 0, 3, 8
"c:\Users\Jonathan\Desktop\breakfast-and-after-school-club\src\components\errors\error-fallback.component.jsx", "JavaScript", 0, 0, 43, 0, 0, 0, 9, 52
"c:\Users\Jonathan\Desktop\breakfast-and-after-school-club\src\components\errors\errors-hooks\use-handle-show-error.js", "JavaScript", 0, 0, 40, 0, 0, 0, 8, 48
"c:\Users\Jonathan\Desktop\breakfast-and-after-school-club\src\components\errors\get-session-prices-error.component.jsx", "JavaScript", 0, 0, 42, 0, 0, 0, 11, 53
"c:\Users\Jonathan\Desktop\breakfast-and-after-school-club\src\components\errors\network-error.component.jsx", "JavaScript", 0, 0, 39, 0, 0, 0, 8, 47
"c:\Users\Jonathan\Desktop\breakfast-and-after-school-club\src\components\errors\show-fetch-errors.component.jsx", "JavaScript", 0, 0, 50, 0, 0, 0, 9, 59
"c:\Users\Jonathan\Desktop\breakfast-and-after-school-club\src\components\floating-add-button\floating-add-button.component.jsx", "JavaScript", 0, 0, 11, 0, 0, 0, 4, 15
"c:\Users\Jonathan\Desktop\breakfast-and-after-school-club\src\components\floating-back-button\floating-back-button.component.jsx", "JavaScript", 0, 0, 57, 0, 0, 0, 11, 68
"c:\Users\Jonathan\Desktop\breakfast-and-after-school-club\src\components\floating-back-button\use-back-button.js", "JavaScript", 0, 0, 24, 0, 0, 0, 8, 32
"c:\Users\Jonathan\Desktop\breakfast-and-after-school-club\src\components\loader\loader.component.jsx", "JavaScript", 0, 0, 10, 0, 0, 0, 3, 13
"c:\Users\Jonathan\Desktop\breakfast-and-after-school-club\src\components\private-routes\private-routes.component.jsx", "JavaScript", 0, 0, 9, 0, 0, 0, 5, 14
"c:\Users\Jonathan\Desktop\breakfast-and-after-school-club\src\components\progressive-image\progressive-image.component.jsx", "JavaScript", 0, 0, 28, 0, 0, 0, 7, 35
"c:\Users\Jonathan\Desktop\breakfast-and-after-school-club\src\components\tables\bookings-table-pagination.component.jsx", "JavaScript", 0, 0, 96, 0, 0, 0, 8, 104
"c:\Users\Jonathan\Desktop\breakfast-and-after-school-club\src\components\tables\bookings-table-render-table.component.jsx", "JavaScript", 0, 0, 100, 0, 0, 0, 6, 106
"c:\Users\Jonathan\Desktop\breakfast-and-after-school-club\src\components\tables\default-table.component.jsx", "JavaScript", 0, 0, 49, 0, 0, 0, 3, 52
"c:\Users\Jonathan\Desktop\breakfast-and-after-school-club\src\components\tables\no-search-result.component.jsx", "JavaScript", 0, 0, 14, 0, 0, 0, 3, 17
"c:\Users\Jonathan\Desktop\breakfast-and-after-school-club\src\components\tables\table-checkbox.jsx", "JavaScript", 0, 0, 14, 0, 0, 0, 5, 19
"c:\Users\Jonathan\Desktop\breakfast-and-after-school-club\src\components\tables\table-help.component.jsx", "JavaScript", 0, 0, 165, 0, 0, 0, 12, 177
"c:\Users\Jonathan\Desktop\breakfast-and-after-school-club\src\components\tables\table-no-entries-info.component.jsx", "JavaScript", 0, 0, 14, 0, 0, 0, 3, 17
"c:\Users\Jonathan\Desktop\breakfast-and-after-school-club\src\components\tables\table-search-box.component.jsx", "JavaScript", 0, 0, 49, 0, 0, 0, 10, 59
"c:\Users\Jonathan\Desktop\breakfast-and-after-school-club\src\components\wallet-balance\wallet-balance-hooks\use-get-wallet-balance.js", "JavaScript", 0, 0, 65, 0, 0, 1, 12, 78
"c:\Users\Jonathan\Desktop\breakfast-and-after-school-club\src\components\wallet-balance\wallet-balance.component.jsx", "JavaScript", 0, 0, 50, 0, 0, 0, 12, 62
"c:\Users\Jonathan\Desktop\breakfast-and-after-school-club\src\functions\capitalize-string.js", "JavaScript", 0, 0, 8, 0, 0, 0, 2, 10
"c:\Users\Jonathan\Desktop\breakfast-and-after-school-club\src\functions\create-children-to-add-to-booking.js", "JavaScript", 0, 0, 14, 0, 0, 0, 1, 15
"c:\Users\Jonathan\Desktop\breakfast-and-after-school-club\src\functions\get-school-db-and-user-collection-ids.js", "JavaScript", 0, 0, 16, 0, 0, 0, 3, 19
"c:\Users\Jonathan\Desktop\breakfast-and-after-school-club\src\functions\get-session-type-string.js", "JavaScript", 0, 0, 14, 0, 0, 0, 1, 15
"c:\Users\Jonathan\Desktop\breakfast-and-after-school-club\src\functions\is-not-valid-school-code.js", "JavaScript", 0, 0, 4, 0, 0, 0, 2, 6
"c:\Users\Jonathan\Desktop\breakfast-and-after-school-club\src\functions\open-email-link.js", "JavaScript", 0, 0, 7, 0, 0, 0, 3, 10
"c:\Users\Jonathan\Desktop\breakfast-and-after-school-club\src\functions\price-multiplied-by-100.js", "JavaScript", 0, 0, 3, 0, 0, 0, 1, 4
"c:\Users\Jonathan\Desktop\breakfast-and-after-school-club\src\functions\set-environment-variables.js", "JavaScript", 0, 0, 72, 0, 0, 0, 3, 75
"c:\Users\Jonathan\Desktop\breakfast-and-after-school-club\src\functions\set-project-id.js", "JavaScript", 0, 0, 12, 0, 0, 0, 3, 15
"c:\Users\Jonathan\Desktop\breakfast-and-after-school-club\src\functions\validate-email.js", "JavaScript", 0, 0, 4, 0, 0, 0, 1, 5
"c:\Users\Jonathan\Desktop\breakfast-and-after-school-club\src\global-styles.js", "JavaScript", 0, 0, 53, 0, 0, 0, 8, 61
"c:\Users\Jonathan\Desktop\breakfast-and-after-school-club\src\hooks\use-cancel-and-return.js", "JavaScript", 0, 0, 42, 0, 0, 0, 7, 49
"c:\Users\Jonathan\Desktop\breakfast-and-after-school-club\src\hooks\use-confirm-swal.js", "JavaScript", 0, 0, 72, 0, 0, 0, 7, 79
"c:\Users\Jonathan\Desktop\breakfast-and-after-school-club\src\hooks\use-fire-swal.js", "JavaScript", 0, 0, 33, 0, 0, 0, 5, 38
"c:\Users\Jonathan\Desktop\breakfast-and-after-school-club\src\hooks\use-get-price-of-booking.js", "JavaScript", 0, 0, 16, 0, 0, 2, 7, 25
"c:\Users\Jonathan\Desktop\breakfast-and-after-school-club\src\hooks\use-get-user-on-load.js", "JavaScript", 0, 0, 16, 0, 0, 0, 4, 20
"c:\Users\Jonathan\Desktop\breakfast-and-after-school-club\src\hooks\use-get-users-children-and-conditionally-user-bookings-and-session-prices.js", "JavaScript", 0, 0, 73, 0, 0, 0, 9, 82
"c:\Users\Jonathan\Desktop\breakfast-and-after-school-club\src\hooks\use-get-window-width.js", "JavaScript", 0, 0, 22, 0, 0, 0, 8, 30
"c:\Users\Jonathan\Desktop\breakfast-and-after-school-club\src\hooks\use-hamburger-handler-navigate.js", "JavaScript", 0, 0, 33, 0, 0, 0, 9, 42
"c:\Users\Jonathan\Desktop\breakfast-and-after-school-club\src\hooks\use-is-mobile-device.js", "JavaScript", 0, 0, 34, 0, 0, 0, 7, 41
"c:\Users\Jonathan\Desktop\breakfast-and-after-school-club\src\hooks\use-is-online.js", "JavaScript", 0, 0, 36, 0, 0, 0, 9, 45
"c:\Users\Jonathan\Desktop\breakfast-and-after-school-club\src\hooks\use-is-route-with-nav-warning.js", "JavaScript", 0, 0, 21, 0, 0, 0, 6, 27
"c:\Users\Jonathan\Desktop\breakfast-and-after-school-club\src\hooks\use-reset-all-store-on-sign-out.js", "JavaScript", 0, 0, 62, 0, 0, 0, 6, 68
"c:\Users\Jonathan\Desktop\breakfast-and-after-school-club\src\hooks\use-reset-password-request-result-swal.js", "JavaScript", 0, 0, 62, 0, 0, 0, 9, 71
"c:\Users\Jonathan\Desktop\breakfast-and-after-school-club\src\hooks\use-reset-store.js", "JavaScript", 0, 0, 132, 0, 0, 0, 7, 139
"c:\Users\Jonathan\Desktop\breakfast-and-after-school-club\src\hooks\use-wallet-balance-listener.js", "JavaScript", 0, 0, 28, 0, 0, 0, 9, 37
"c:\Users\Jonathan\Desktop\breakfast-and-after-school-club\src\index.css", "CSS", 0, 12, 0, 0, 0, 0, 2, 14
"c:\Users\Jonathan\Desktop\breakfast-and-after-school-club\src\main.jsx", "JavaScript", 0, 0, 42, 0, 0, 0, 5, 47
"c:\Users\Jonathan\Desktop\breakfast-and-after-school-club\src\routes\account\account-button-links.component.jsx", "JavaScript", 0, 0, 41, 0, 0, 0, 8, 49
"c:\Users\Jonathan\Desktop\breakfast-and-after-school-club\src\routes\account\account-hooks\use-check-for-and-clear-form-details.js", "JavaScript", 0, 0, 44, 0, 0, 0, 8, 52
"c:\Users\Jonathan\Desktop\breakfast-and-after-school-club\src\routes\account\account-hooks\use-navigate-to-route.js", "JavaScript", 0, 0, 73, 0, 0, 0, 7, 80
"c:\Users\Jonathan\Desktop\breakfast-and-after-school-club\src\routes\account\account-stripe-logo.component.jsx", "JavaScript", 0, 0, 22, 0, 0, 0, 7, 29
"c:\Users\Jonathan\Desktop\breakfast-and-after-school-club\src\routes\account\account.component.jsx", "JavaScript", 0, 0, 21, 0, 0, 0, 8, 29
"c:\Users\Jonathan\Desktop\breakfast-and-after-school-club\src\routes\account\intro.component.jsx", "JavaScript", 0, 0, 16, 0, 0, 0, 7, 23
"c:\Users\Jonathan\Desktop\breakfast-and-after-school-club\src\routes\add-child-info\add-child-info-button.component.jsx", "JavaScript", 0, 0, 33, 0, 0, 0, 10, 43
"c:\Users\Jonathan\Desktop\breakfast-and-after-school-club\src\routes\add-child-info\add-child-info-form.component.jsx", "JavaScript", 0, 0, 78, 0, 0, 0, 16, 94
"c:\Users\Jonathan\Desktop\breakfast-and-after-school-club\src\routes\add-child-info\add-child-info-hooks\use-add-child-info-result-swal.js", "JavaScript", 0, 0, 85, 0, 0, 1, 12, 98
"c:\Users\Jonathan\Desktop\breakfast-and-after-school-club\src\routes\add-child-info\add-child-info-hooks\use-confirm-add-child-info.js", "JavaScript", 0, 0, 61, 0, 0, 1, 14, 76
"c:\Users\Jonathan\Desktop\breakfast-and-after-school-club\src\routes\add-child-info\add-child-info-hooks\use-handle-add-child-info-change.js", "JavaScript", 0, 0, 15, 0, 0, 0, 7, 22
"c:\Users\Jonathan\Desktop\breakfast-and-after-school-club\src\routes\add-child-info\add-child-info.component.jsx", "JavaScript", 0, 0, 22, 0, 0, 0, 11, 33
"c:\Users\Jonathan\Desktop\breakfast-and-after-school-club\src\routes\add-funds\add-funds-button.component.jsx", "JavaScript", 0, 0, 17, 0, 0, 0, 4, 21
"c:\Users\Jonathan\Desktop\breakfast-and-after-school-club\src\routes\add-funds\add-funds-hooks\use-clear-card-input-on-zero-wallet-funds.js", "JavaScript", 0, 0, 35, 0, 0, 0, 7, 42
"c:\Users\Jonathan\Desktop\breakfast-and-after-school-club\src\routes\add-funds\add-funds-hooks\use-get-client-secret.js", "JavaScript", 0, 0, 19, 0, 0, 0, 9, 28
"c:\Users\Jonathan\Desktop\breakfast-and-after-school-club\src\routes\add-funds\add-funds-hooks\use-get-payment-result.js", "JavaScript", 0, 0, 89, 0, 0, 0, 15, 104
"c:\Users\Jonathan\Desktop\breakfast-and-after-school-club\src\routes\add-funds\add-funds-hooks\use-handle-card-input-change.js", "JavaScript", 0, 0, 35, 0, 0, 0, 6, 41
"c:\Users\Jonathan\Desktop\breakfast-and-after-school-club\src\routes\add-funds\add-funds-hooks\use-handle-wallet-funds-change.js", "JavaScript", 0, 0, 19, 0, 0, 0, 8, 27
"c:\Users\Jonathan\Desktop\breakfast-and-after-school-club\src\routes\add-funds\add-funds-hooks\use-should-show-add-funds-button.component.js", "JavaScript", 0, 0, 19, 0, 0, 0, 7, 26
"c:\Users\Jonathan\Desktop\breakfast-and-after-school-club\src\routes\add-funds\add-funds.component.jsx", "JavaScript", 0, 0, 29, 0, 0, 0, 9, 38
"c:\Users\Jonathan\Desktop\breakfast-and-after-school-club\src\routes\add-funds\card-input-styles\card-input-styles.js", "JavaScript", 0, 0, 20, 0, 0, 0, 1, 21
"c:\Users\Jonathan\Desktop\breakfast-and-after-school-club\src\routes\add-funds\card-input.component.jsx", "JavaScript", 0, 0, 37, 0, 0, 0, 9, 46
"c:\Users\Jonathan\Desktop\breakfast-and-after-school-club\src\routes\add-funds\choose-wallet-funds-to-add.component.jsx", "JavaScript", 0, 0, 34, 0, 0, 0, 9, 43
"c:\Users\Jonathan\Desktop\breakfast-and-after-school-club\src\routes\add-funds\errors-help-redirect\add-funds-help.component.jsx", "JavaScript", 0, 0, 56, 0, 0, 0, 7, 63
"c:\Users\Jonathan\Desktop\breakfast-and-after-school-club\src\routes\add-funds\errors-help-redirect\card-input-errors.component.jsx", "JavaScript", 0, 0, 24, 0, 0, 0, 7, 31
"c:\Users\Jonathan\Desktop\breakfast-and-after-school-club\src\routes\add-funds\errors-help-redirect\redirect-and-loader.component.jsx", "JavaScript", 0, 0, 19, 0, 0, 0, 7, 26
"c:\Users\Jonathan\Desktop\breakfast-and-after-school-club\src\routes\book-a-session\book-a-session-hooks\emails\use-send-add-booking-info-error-email.js", "JavaScript", 0, 0, 77, 0, 0, 0, 13, 90
"c:\Users\Jonathan\Desktop\breakfast-and-after-school-club\src\routes\book-a-session\book-a-session-hooks\emails\use-send-email-booking-confirmation.js", "JavaScript", 0, 0, 71, 0, 0, 1, 15, 87
"c:\Users\Jonathan\Desktop\breakfast-and-after-school-club\src\routes\book-a-session\book-a-session-hooks\emails\use-send-reset-session-spaces-error-email.js", "JavaScript", 0, 0, 55, 0, 0, 0, 10, 65
"c:\Users\Jonathan\Desktop\breakfast-and-after-school-club\src\routes\book-a-session\book-a-session-hooks\swals\use-add-session-booking-info-error-swal.js", "JavaScript", 0, 0, 26, 0, 0, 1, 7, 34
"c:\Users\Jonathan\Desktop\breakfast-and-after-school-club\src\routes\book-a-session\book-a-session-hooks\swals\use-get-book-session-result-swal.js", "JavaScript", 0, 0, 56, 0, 0, 0, 8, 64
"c:\Users\Jonathan\Desktop\breakfast-and-after-school-club\src\routes\book-a-session\book-a-session-hooks\swals\use-session-already-booked-swal.js", "JavaScript", 0, 0, 27, 0, 0, 0, 9, 36
"c:\Users\Jonathan\Desktop\breakfast-and-after-school-club\src\routes\book-a-session\book-a-session-hooks\swals\use-session-spaces-error-swals.js", "JavaScript", 0, 0, 66, 0, 0, 0, 13, 79
"c:\Users\Jonathan\Desktop\breakfast-and-after-school-club\src\routes\book-a-session\book-a-session-hooks\swals\use-success-swal.js", "JavaScript", 0, 0, 26, 0, 0, 0, 8, 34
"c:\Users\Jonathan\Desktop\breakfast-and-after-school-club\src\routes\book-a-session\book-a-session-hooks\swals\use-update-balance-error-reset-session-doc-swal.js", "JavaScript", 0, 0, 71, 0, 0, 5, 11, 87
"c:\Users\Jonathan\Desktop\breakfast-and-after-school-club\src\routes\book-a-session\book-a-session-hooks\swals\use-update-session-doc-error-swal.js", "JavaScript", 0, 0, 47, 0, 0, 0, 9, 56
"c:\Users\Jonathan\Desktop\breakfast-and-after-school-club\src\routes\book-a-session\book-a-session-hooks\use-check-for-previous-booking-and-confirm-session.js", "JavaScript", 0, 0, 43, 0, 0, 0, 10, 53
"c:\Users\Jonathan\Desktop\breakfast-and-after-school-club\src\routes\book-a-session\book-a-session-hooks\use-child-session-already-booked.js", "JavaScript", 0, 0, 64, 0, 0, 3, 16, 83
"c:\Users\Jonathan\Desktop\breakfast-and-after-school-club\src\routes\book-a-session\book-a-session-hooks\use-choose-date-handle-change.js", "JavaScript", 0, 0, 10, 0, 0, 0, 6, 16
"c:\Users\Jonathan\Desktop\breakfast-and-after-school-club\src\routes\book-a-session\book-a-session-hooks\use-conditional-logic.js", "JavaScript", 0, 0, 226, 0, 0, 4, 36, 266
"c:\Users\Jonathan\Desktop\breakfast-and-after-school-club\src\routes\book-a-session\book-a-session-hooks\use-confirm-result.js", "JavaScript", 0, 0, 67, 0, 0, 0, 9, 76
"c:\Users\Jonathan\Desktop\breakfast-and-after-school-club\src\routes\book-a-session\book-a-session-hooks\use-confirm-session.js", "JavaScript", 0, 0, 50, 0, 0, 0, 9, 59
"c:\Users\Jonathan\Desktop\breakfast-and-after-school-club\src\routes\book-a-session\book-a-session-hooks\use-get-booking-data-and-session-type-to-lowercase.js", "JavaScript", 0, 0, 43, 0, 0, 0, 12, 55
"c:\Users\Jonathan\Desktop\breakfast-and-after-school-club\src\routes\book-a-session\book-a-session-hooks\use-get-date-data-early-finish-dates-and-booking-closing-times.js", "JavaScript", 0, 0, 85, 0, 0, 0, 8, 93
"c:\Users\Jonathan\Desktop\breakfast-and-after-school-club\src\routes\book-a-session\book-a-session-hooks\use-return-logic.js", "JavaScript", 0, 0, 42, 0, 0, 0, 10, 52
"c:\Users\Jonathan\Desktop\breakfast-and-after-school-club\src\routes\book-a-session\book-a-session-hooks\use-session-spaces-listener.js", "JavaScript", 0, 0, 34, 0, 0, 0, 11, 45
"c:\Users\Jonathan\Desktop\breakfast-and-after-school-club\src\routes\book-a-session\book-a-session-hooks\use-set-date-and-time.js", "JavaScript", 0, 0, 13, 0, 0, 0, 6, 19
"c:\Users\Jonathan\Desktop\breakfast-and-after-school-club\src\routes\book-a-session\book-a-session.component.jsx", "JavaScript", 0, 0, 45, 0, 0, 0, 9, 54
"c:\Users\Jonathan\Desktop\breakfast-and-after-school-club\src\routes\book-a-session\sections\balance-check-and-book-session-help.component.jsx", "JavaScript", 0, 0, 27, 0, 0, 0, 7, 34
"c:\Users\Jonathan\Desktop\breakfast-and-after-school-club\src\routes\book-a-session\sections\buttons\afternoon-session-long-button.component.jsx", "JavaScript", 0, 0, 36, 0, 0, 2, 10, 48
"c:\Users\Jonathan\Desktop\breakfast-and-after-school-club\src\routes\book-a-session\sections\buttons\afternoon-session-short-button.component.jsx", "JavaScript", 0, 0, 36, 0, 0, 0, 10, 46
"c:\Users\Jonathan\Desktop\breakfast-and-after-school-club\src\routes\book-a-session\sections\buttons\morning-and-afternoon-session-long-button.component.jsx", "JavaScript", 0, 0, 34, 0, 0, 0, 8, 42
"c:\Users\Jonathan\Desktop\breakfast-and-after-school-club\src\routes\book-a-session\sections\buttons\morning-and-afternoon-session-short-button.component.jsx", "JavaScript", 0, 0, 34, 0, 0, 0, 9, 43
"c:\Users\Jonathan\Desktop\breakfast-and-after-school-club\src\routes\book-a-session\sections\buttons\morning-session-button.component.jsx", "JavaScript", 0, 0, 34, 0, 0, 0, 9, 43
"c:\Users\Jonathan\Desktop\breakfast-and-after-school-club\src\routes\book-a-session\sections\child-checkbox.component.jsx", "JavaScript", 0, 0, 47, 0, 0, 0, 10, 57
"c:\Users\Jonathan\Desktop\breakfast-and-after-school-club\src\routes\book-a-session\sections\choose-date.component.jsx", "JavaScript", 0, 0, 32, 0, 0, 0, 6, 38
"c:\Users\Jonathan\Desktop\breakfast-and-after-school-club\src\routes\book-a-session\sections\choose-sessions.component.jsx", "JavaScript", 0, 0, 70, 0, 0, 0, 9, 79
"c:\Users\Jonathan\Desktop\breakfast-and-after-school-club\src\routes\book-a-session\sections\date-errors.component.jsx", "JavaScript", 0, 0, 57, 0, 0, 0, 5, 62
"c:\Users\Jonathan\Desktop\breakfast-and-after-school-club\src\routes\book-a-session\sections\heading-times-and-prices-wallet-balance-options-info.component.jsx", "JavaScript", 0, 0, 16, 0, 0, 0, 4, 20
"c:\Users\Jonathan\Desktop\breakfast-and-after-school-club\src\routes\book-a-session\sections\loaders.component.jsx", "JavaScript", 0, 0, 27, 0, 0, 0, 7, 34
"c:\Users\Jonathan\Desktop\breakfast-and-after-school-club\src\routes\book-a-session\sections\options-available-info.component.jsx", "JavaScript", 0, 0, 27, 0, 0, 0, 6, 33
"c:\Users\Jonathan\Desktop\breakfast-and-after-school-club\src\routes\book-a-session\sections\session-help-accordion.component.jsx", "JavaScript", 0, 0, 100, 0, 0, 0, 10, 110
"c:\Users\Jonathan\Desktop\breakfast-and-after-school-club\src\routes\book-a-session\sections\spaces-available-info.component.jsx", "JavaScript", 0, 0, 19, 0, 0, 0, 5, 24
"c:\Users\Jonathan\Desktop\breakfast-and-after-school-club\src\routes\book-a-session\sections\times-and-prices-accordion.component.jsx", "JavaScript", 0, 0, 110, 0, 0, 1, 9, 120
"c:\Users\Jonathan\Desktop\breakfast-and-after-school-club\src\routes\cancel-booking\cancel-booking.component.jsx", "JavaScript", 0, 0, 14, 0, 0, 0, 6, 20
"c:\Users\Jonathan\Desktop\breakfast-and-after-school-club\src\routes\cancel-booking\hooks\emails\use-send-balance-not-updated-error-email.js", "JavaScript", 0, 0, 51, 0, 0, 0, 12, 63
"c:\Users\Jonathan\Desktop\breakfast-and-after-school-club\src\routes\cancel-booking\hooks\emails\use-send-cancellation-email.js", "JavaScript", 0, 0, 60, 0, 0, 1, 11, 72
"c:\Users\Jonathan\Desktop\breakfast-and-after-school-club\src\routes\cancel-booking\hooks\emails\use-send-session-spaces-and-balance-error-email.js", "JavaScript", 0, 0, 65, 0, 0, 0, 13, 78
"c:\Users\Jonathan\Desktop\breakfast-and-after-school-club\src\routes\cancel-booking\hooks\swals\use-cancel-booking-result-swal.js", "JavaScript", 0, 0, 59, 0, 0, 0, 8, 67
"c:\Users\Jonathan\Desktop\breakfast-and-after-school-club\src\routes\cancel-booking\hooks\swals\use-success-swal.js", "JavaScript", 0, 0, 26, 0, 0, 0, 6, 32
"c:\Users\Jonathan\Desktop\breakfast-and-after-school-club\src\routes\cancel-booking\hooks\swals\use-update-balance-error-swal.js", "JavaScript", 0, 0, 24, 0, 0, 0, 6, 30
"c:\Users\Jonathan\Desktop\breakfast-and-after-school-club\src\routes\cancel-booking\hooks\swals\use-update-bookings-result-error-swal.js", "JavaScript", 0, 0, 31, 0, 0, 0, 10, 41
"c:\Users\Jonathan\Desktop\breakfast-and-after-school-club\src\routes\cancel-booking\hooks\swals\use-update-session-spaces-and-balance-error-swal.js", "JavaScript", 0, 0, 24, 0, 0, 1, 7, 32
"c:\Users\Jonathan\Desktop\breakfast-and-after-school-club\src\routes\cancel-booking\hooks\use-confirm-cancel-booking.js", "JavaScript", 0, 0, 86, 0, 0, 0, 11, 97
"c:\Users\Jonathan\Desktop\breakfast-and-after-school-club\src\routes\cancel-booking\hooks\use-get-refund-price.js", "JavaScript", 0, 0, 58, 0, 0, 1, 12, 71
"c:\Users\Jonathan\Desktop\breakfast-and-after-school-club\src\routes\cancel-booking\hooks\use-get-session-prices.js", "JavaScript", 0, 0, 30, 0, 0, 0, 6, 36
"c:\Users\Jonathan\Desktop\breakfast-and-after-school-club\src\routes\cancel-booking\hooks\use-return-logic.js", "JavaScript", 0, 0, 37, 0, 0, 0, 9, 46
"c:\Users\Jonathan\Desktop\breakfast-and-after-school-club\src\routes\cancel-booking\loader-title-buttons.component.jsx", "JavaScript", 0, 0, 47, 0, 0, 0, 13, 60
"c:\Users\Jonathan\Desktop\breakfast-and-after-school-club\src\routes\cancel-booking\wallet-update-info.component.jsx", "JavaScript", 0, 0, 59, 0, 0, 0, 19, 78
"c:\Users\Jonathan\Desktop\breakfast-and-after-school-club\src\routes\child-info\child-info-accordion.component.jsx", "JavaScript", 0, 0, 58, 0, 0, 0, 7, 65
"c:\Users\Jonathan\Desktop\breakfast-and-after-school-club\src\routes\child-info\child-info-hooks\use-get-users-children-error-swal.js", "JavaScript", 0, 0, 35, 0, 0, 0, 8, 43
"c:\Users\Jonathan\Desktop\breakfast-and-after-school-club\src\routes\child-info\child-info-hooks\use-get-users-children-listener.js", "JavaScript", 0, 0, 35, 0, 0, 1, 9, 45
"c:\Users\Jonathan\Desktop\breakfast-and-after-school-club\src\routes\child-info\child-info.component.jsx", "JavaScript", 0, 0, 34, 0, 0, 0, 13, 47
"c:\Users\Jonathan\Desktop\breakfast-and-after-school-club\src\routes\child-info\child-table.component.jsx", "JavaScript", 0, 0, 95, 0, 0, 0, 16, 111
"c:\Users\Jonathan\Desktop\breakfast-and-after-school-club\src\routes\child-info\edit-remove-buttons.component.jsx", "JavaScript", 0, 0, 47, 0, 0, 0, 8, 55
"c:\Users\Jonathan\Desktop\breakfast-and-after-school-club\src\routes\child-info\table-columns.js", "JavaScript", 0, 0, 22, 0, 0, 0, 1, 23
"c:\Users\Jonathan\Desktop\breakfast-and-after-school-club\src\routes\choose-new-password\choose-new-password-hooks\use-choose-new-password-result-swal.js", "JavaScript", 0, 0, 82, 0, 0, 0, 10, 92
"c:\Users\Jonathan\Desktop\breakfast-and-after-school-club\src\routes\choose-new-password\choose-new-password-hooks\use-confirm-update-password.js", "JavaScript", 0, 0, 32, 0, 0, 0, 11, 43
"c:\Users\Jonathan\Desktop\breakfast-and-after-school-club\src\routes\choose-new-password\choose-new-password-hooks\use-handle-choose-new-password-form-change.js", "JavaScript", 0, 0, 15, 0, 0, 0, 6, 21
"c:\Users\Jonathan\Desktop\breakfast-and-after-school-club\src\routes\choose-new-password\choose-new-password-hooks\use-hide-reset-password-fields-on-empty.js", "JavaScript", 0, 0, 32, 0, 0, 0, 7, 39
"c:\Users\Jonathan\Desktop\breakfast-and-after-school-club\src\routes\choose-new-password\choose-new-password.component.jsx", "JavaScript", 0, 0, 29, 0, 0, 0, 11, 40
"c:\Users\Jonathan\Desktop\breakfast-and-after-school-club\src\routes\choose-new-password\sections\intro.component.jsx", "JavaScript", 0, 0, 20, 0, 0, 0, 5, 25
"c:\Users\Jonathan\Desktop\breakfast-and-after-school-club\src\routes\choose-new-password\sections\new-passwords.component.jsx", "JavaScript", 0, 0, 70, 0, 0, 0, 12, 82
"c:\Users\Jonathan\Desktop\breakfast-and-after-school-club\src\routes\choose-new-password\sections\update-password-button.component.jsx", "JavaScript", 0, 0, 29, 0, 0, 0, 9, 38
"c:\Users\Jonathan\Desktop\breakfast-and-after-school-club\src\routes\chosen-entry-child-details\child-details.component.jsx", "JavaScript", 0, 0, 66, 0, 0, 0, 15, 81
"c:\Users\Jonathan\Desktop\breakfast-and-after-school-club\src\routes\chosen-entry-child-details\chosen-entry-child-details-accordion.component.jsx", "JavaScript", 0, 0, 41, 0, 0, 0, 9, 50
"c:\Users\Jonathan\Desktop\breakfast-and-after-school-club\src\routes\chosen-entry-child-details\chosen-entry-child-details-hooks\use-get-chosen-entry-child-details-error-swal.js", "JavaScript", 0, 0, 37, 0, 0, 0, 10, 47
"c:\Users\Jonathan\Desktop\breakfast-and-after-school-club\src\routes\chosen-entry-child-details\chosen-entry-child-details-hooks\use-get-chosen-entry-child-details.js", "JavaScript", 0, 0, 31, 0, 0, 0, 6, 37
"c:\Users\Jonathan\Desktop\breakfast-and-after-school-club\src\routes\chosen-entry-child-details\chosen-entry-child-details.component.jsx", "JavaScript", 0, 0, 25, 0, 0, 0, 9, 34
"c:\Users\Jonathan\Desktop\breakfast-and-after-school-club\src\routes\chosen-entry-child-details\title-and-loader.component.jsx", "JavaScript", 0, 0, 19, 0, 0, 0, 7, 26
"c:\Users\Jonathan\Desktop\breakfast-and-after-school-club\src\routes\close-account\close-account-hooks\use-account-closure-email.js", "JavaScript", 0, 0, 19, 0, 0, 0, 15, 34
"c:\Users\Jonathan\Desktop\breakfast-and-after-school-club\src\routes\close-account\close-account-hooks\use-close-account-swal.js", "JavaScript", 0, 0, 54, 0, 0, 0, 10, 64
"c:\Users\Jonathan\Desktop\breakfast-and-after-school-club\src\routes\close-account\close-account-hooks\use-confirm-close-account.js", "JavaScript", 0, 0, 53, 0, 0, 0, 11, 64
"c:\Users\Jonathan\Desktop\breakfast-and-after-school-club\src\routes\close-account\close-account.component.jsx", "JavaScript", 0, 0, 58, 0, 0, 0, 12, 70
"c:\Users\Jonathan\Desktop\breakfast-and-after-school-club\src\routes\contact\contact-form-hooks\use-confirm-send-contact-form-message.js", "JavaScript", 0, 0, 51, 0, 0, 0, 14, 65
"c:\Users\Jonathan\Desktop\breakfast-and-after-school-club\src\routes\contact\contact-form-hooks\use-handle-contact-form-details-change.js", "JavaScript", 0, 0, 15, 0, 0, 0, 6, 21
"c:\Users\Jonathan\Desktop\breakfast-and-after-school-club\src\routes\contact\contact-form-hooks\use-send-contact-form-message-result-swal.js", "JavaScript", 0, 0, 52, 0, 0, 0, 8, 60
"c:\Users\Jonathan\Desktop\breakfast-and-after-school-club\src\routes\contact\contact.component.jsx", "JavaScript", 0, 0, 22, 0, 0, 0, 11, 33
"c:\Users\Jonathan\Desktop\breakfast-and-after-school-club\src\routes\contact\sections\contact-form.component.jsx", "JavaScript", 0, 0, 58, 0, 0, 0, 13, 71
"c:\Users\Jonathan\Desktop\breakfast-and-after-school-club\src\routes\contact\sections\send-message-button.component.jsx", "JavaScript", 0, 0, 36, 0, 0, 0, 10, 46
"c:\Users\Jonathan\Desktop\breakfast-and-after-school-club\src\routes\delete-child-info\delete-and-return-buttons.component.jsx", "JavaScript", 0, 0, 21, 0, 0, 0, 7, 28
"c:\Users\Jonathan\Desktop\breakfast-and-after-school-club\src\routes\delete-child-info\delete-child-info.component.jsx", "JavaScript", 0, 0, 14, 0, 0, 0, 6, 20
"c:\Users\Jonathan\Desktop\breakfast-and-after-school-club\src\routes\delete-child-info\hooks\use-confirm-delete-child-info.js", "JavaScript", 0, 0, 26, 0, 0, 0, 11, 37
"c:\Users\Jonathan\Desktop\breakfast-and-after-school-club\src\routes\delete-child-info\hooks\use-delete-child-info-result-swal.js", "JavaScript", 0, 0, 58, 0, 0, 0, 10, 68
"c:\Users\Jonathan\Desktop\breakfast-and-after-school-club\src\routes\delete-child-info\loader-title-info.component.jsx", "JavaScript", 0, 0, 26, 0, 0, 0, 10, 36
"c:\Users\Jonathan\Desktop\breakfast-and-after-school-club\src\routes\edit-child-info\edit-and-return-buttons.component.jsx", "JavaScript", 0, 0, 23, 0, 0, 0, 6, 29
"c:\Users\Jonathan\Desktop\breakfast-and-after-school-club\src\routes\edit-child-info\edit-child-info-form.component.jsx", "JavaScript", 0, 0, 71, 0, 0, 0, 13, 84
"c:\Users\Jonathan\Desktop\breakfast-and-after-school-club\src\routes\edit-child-info\edit-child-info.component.jsx", "JavaScript", 0, 0, 24, 0, 0, 0, 10, 34
"c:\Users\Jonathan\Desktop\breakfast-and-after-school-club\src\routes\edit-child-info\hooks\use-confirm-update-child-info.js", "JavaScript", 0, 0, 63, 0, 0, 0, 14, 77
"c:\Users\Jonathan\Desktop\breakfast-and-after-school-club\src\routes\edit-child-info\hooks\use-edit-child-info-result-swal.js", "JavaScript", 0, 0, 52, 0, 0, 0, 10, 62
"c:\Users\Jonathan\Desktop\breakfast-and-after-school-club\src\routes\edit-child-info\hooks\use-handle-updated-child-info-change.js", "JavaScript", 0, 0, 22, 0, 0, 0, 7, 29
"c:\Users\Jonathan\Desktop\breakfast-and-after-school-club\src\routes\edit-child-info\hooks\use-prevent-show-if-no-data.js", "JavaScript", 0, 0, 15, 0, 0, 0, 7, 22
"c:\Users\Jonathan\Desktop\breakfast-and-after-school-club\src\routes\forgot-password-request\forgot-password-request-hooks\use-handle-forgot-password-request-email-change.js", "JavaScript", 0, 0, 10, 0, 0, 0, 6, 16
"c:\Users\Jonathan\Desktop\breakfast-and-after-school-club\src\routes\forgot-password-request\forgot-password-request.component.jsx", "JavaScript", 0, 0, 65, 0, 0, 0, 15, 80
"c:\Users\Jonathan\Desktop\breakfast-and-after-school-club\src\routes\home\home.component.jsx", "JavaScript", 0, 0, 12, 0, 0, 0, 4, 16
"c:\Users\Jonathan\Desktop\breakfast-and-after-school-club\src\routes\home\info.component.jsx", "JavaScript", 0, 0, 64, 0, 0, 0, 10, 74
"c:\Users\Jonathan\Desktop\breakfast-and-after-school-club\src\routes\home\intro.component.jsx", "JavaScript", 0, 0, 18, 0, 0, 0, 4, 22
"c:\Users\Jonathan\Desktop\breakfast-and-after-school-club\src\routes\home\links.component.jsx", "JavaScript", 0, 0, 25, 0, 0, 0, 5, 30
"c:\Users\Jonathan\Desktop\breakfast-and-after-school-club\src\routes\navigation\nav-app-owner.component.jsx", "JavaScript", 0, 0, 38, 0, 0, 0, 10, 48
"c:\Users\Jonathan\Desktop\breakfast-and-after-school-club\src\routes\navigation\nav-hamburger.component.jsx", "JavaScript", 0, 0, 38, 0, 0, 0, 6, 44
"c:\Users\Jonathan\Desktop\breakfast-and-after-school-club\src\routes\navigation\nav-logo.component.jsx", "JavaScript", 0, 0, 38, 0, 0, 0, 10, 48
"c:\Users\Jonathan\Desktop\breakfast-and-after-school-club\src\routes\navigation\nav-no-user.component.jsx", "JavaScript", 0, 0, 33, 0, 0, 0, 9, 42
"c:\Users\Jonathan\Desktop\breakfast-and-after-school-club\src\routes\navigation\nav-not-app-owner.component.jsx", "JavaScript", 0, 0, 74, 0, 0, 0, 12, 86
"c:\Users\Jonathan\Desktop\breakfast-and-after-school-club\src\routes\navigation\nav-sign-out.component.jsx", "JavaScript", 0, 0, 64, 0, 0, 0, 13, 77
"c:\Users\Jonathan\Desktop\breakfast-and-after-school-club\src\routes\navigation\navigation-hooks\use-get-sign-out-error.js", "JavaScript", 0, 0, 35, 0, 0, 0, 10, 45
"c:\Users\Jonathan\Desktop\breakfast-and-after-school-club\src\routes\navigation\navigation.component.jsx", "JavaScript", 0, 0, 48, 0, 0, 0, 10, 58
"c:\Users\Jonathan\Desktop\breakfast-and-after-school-club\src\routes\navigation\routes.js", "JavaScript", 0, 0, 27, 0, 0, 0, 4, 31
"c:\Users\Jonathan\Desktop\breakfast-and-after-school-club\src\routes\payment-result\payment-result-hooks\use-get-payment-result.js", "JavaScript", 0, 0, 28, 0, 0, 2, 9, 39
"c:\Users\Jonathan\Desktop\breakfast-and-after-school-club\src\routes\payment-result\payment-result-hooks\use-handle-payment-failed.js", "JavaScript", 0, 0, 29, 0, 0, 0, 9, 38
"c:\Users\Jonathan\Desktop\breakfast-and-after-school-club\src\routes\payment-result\payment-result-hooks\use-send-update-balance-error-email.js", "JavaScript", 0, 0, 54, 0, 0, 0, 10, 64
"c:\Users\Jonathan\Desktop\breakfast-and-after-school-club\src\routes\payment-result\payment-result-hooks\use-update-wallet-balance.js", "JavaScript", 0, 0, 63, 0, 0, 0, 11, 74
"c:\Users\Jonathan\Desktop\breakfast-and-after-school-club\src\routes\payment-result\payment-result.component.jsx", "JavaScript", 0, 0, 20, 0, 0, 0, 10, 30
"c:\Users\Jonathan\Desktop\breakfast-and-after-school-club\src\routes\sign-in\sections\sign-in-button.component.jsx", "JavaScript", 0, 0, 30, 0, 0, 0, 8, 38
"c:\Users\Jonathan\Desktop\breakfast-and-after-school-club\src\routes\sign-in\sections\sign-in-email.component.jsx", "JavaScript", 0, 0, 20, 0, 0, 0, 7, 27
"c:\Users\Jonathan\Desktop\breakfast-and-after-school-club\src\routes\sign-in\sections\sign-in-password.component.jsx", "JavaScript", 0, 0, 40, 0, 0, 0, 11, 51
"c:\Users\Jonathan\Desktop\breakfast-and-after-school-club\src\routes\sign-in\sections\sign-in-school-code.component.jsx", "JavaScript", 0, 0, 20, 0, 0, 0, 7, 27
"c:\Users\Jonathan\Desktop\breakfast-and-after-school-club\src\routes\sign-in\sign-in-form-hooks\use-handle-sign-in-form-change.js", "JavaScript", 0, 0, 13, 0, 0, 0, 6, 19
"c:\Users\Jonathan\Desktop\breakfast-and-after-school-club\src\routes\sign-in\sign-in-form-hooks\use-handle-sign-in-form-error.js", "JavaScript", 0, 0, 28, 0, 0, 0, 8, 36
"c:\Users\Jonathan\Desktop\breakfast-and-after-school-club\src\routes\sign-in\sign-in-form-hooks\use-handle-sign-in-form-submit.js", "JavaScript", 0, 0, 40, 0, 0, 0, 12, 52
"c:\Users\Jonathan\Desktop\breakfast-and-after-school-club\src\routes\sign-in\sign-in-form-hooks\use-hide-sign-in-password-on-empty.js", "JavaScript", 0, 0, 21, 0, 0, 0, 7, 28
"c:\Users\Jonathan\Desktop\breakfast-and-after-school-club\src\routes\sign-in\sign-in.component.jsx", "JavaScript", 0, 0, 51, 0, 0, 0, 13, 64
"c:\Users\Jonathan\Desktop\breakfast-and-after-school-club\src\routes\sign-up\sections\sign-up-button.component.jsx", "JavaScript", 0, 0, 25, 0, 0, 0, 5, 30
"c:\Users\Jonathan\Desktop\breakfast-and-after-school-club\src\routes\sign-up\sections\sign-up-email.component.jsx", "JavaScript", 0, 0, 16, 0, 0, 0, 3, 19
"c:\Users\Jonathan\Desktop\breakfast-and-after-school-club\src\routes\sign-up\sections\sign-up-name.component.jsx", "JavaScript", 0, 0, 16, 0, 0, 0, 3, 19
"c:\Users\Jonathan\Desktop\breakfast-and-after-school-club\src\routes\sign-up\sections\sign-up-passwords.component.jsx", "JavaScript", 0, 0, 68, 0, 0, 0, 13, 81
"c:\Users\Jonathan\Desktop\breakfast-and-after-school-club\src\routes\sign-up\sections\sign-up-school-code.component.jsx", "JavaScript", 0, 0, 16, 0, 0, 0, 3, 19
"c:\Users\Jonathan\Desktop\breakfast-and-after-school-club\src\routes\sign-up\sign-up-form-hooks\use-handle-sign-up-form-change.js", "JavaScript", 0, 0, 13, 0, 0, 0, 6, 19
"c:\Users\Jonathan\Desktop\breakfast-and-after-school-club\src\routes\sign-up\sign-up-form-hooks\use-handle-sign-up-form-error.js", "JavaScript", 0, 0, 20, 0, 0, 0, 7, 27
"c:\Users\Jonathan\Desktop\breakfast-and-after-school-club\src\routes\sign-up\sign-up-form-hooks\use-handle-sign-up-form-submit.js", "JavaScript", 0, 0, 44, 0, 0, 0, 11, 55
"c:\Users\Jonathan\Desktop\breakfast-and-after-school-club\src\routes\sign-up\sign-up-form-hooks\use-hide-sign-up-password-on-empty.js", "JavaScript", 0, 0, 29, 0, 0, 0, 7, 36
"c:\Users\Jonathan\Desktop\breakfast-and-after-school-club\src\routes\sign-up\sign-up.component.jsx", "JavaScript", 0, 0, 57, 0, 0, 0, 13, 70
"c:\Users\Jonathan\Desktop\breakfast-and-after-school-club\src\routes\update-email\info.component.jsx", "JavaScript", 0, 0, 55, 0, 0, 0, 8, 63
"c:\Users\Jonathan\Desktop\breakfast-and-after-school-club\src\routes\update-email\new-email.component.jsx", "JavaScript", 0, 0, 76, 0, 0, 0, 13, 89
"c:\Users\Jonathan\Desktop\breakfast-and-after-school-club\src\routes\update-email\title-and-loader.component.jsx", "JavaScript", 0, 0, 20, 0, 0, 0, 7, 27
"c:\Users\Jonathan\Desktop\breakfast-and-after-school-club\src\routes\update-email\update-email-hooks\use-confirm-update-email.js", "JavaScript", 0, 0, 56, 0, 0, 0, 13, 69
"c:\Users\Jonathan\Desktop\breakfast-and-after-school-club\src\routes\update-email\update-email-hooks\use-handle-update-email-details.js", "JavaScript", 0, 0, 13, 0, 0, 0, 6, 19
"c:\Users\Jonathan\Desktop\breakfast-and-after-school-club\src\routes\update-email\update-email-hooks\use-hide-update-email-password-on-empty.js", "JavaScript", 0, 0, 21, 0, 0, 0, 6, 27
"c:\Users\Jonathan\Desktop\breakfast-and-after-school-club\src\routes\update-email\update-email-hooks\use-update-email-result-swal.js", "JavaScript", 0, 0, 73, 0, 0, 0, 10, 83
"c:\Users\Jonathan\Desktop\breakfast-and-after-school-club\src\routes\update-email\update-email.component.jsx", "JavaScript", 0, 0, 19, 0, 0, 0, 7, 26
"c:\Users\Jonathan\Desktop\breakfast-and-after-school-club\src\routes\update-password\info.component.jsx", "JavaScript", 0, 0, 50, 0, 0, 0, 8, 58
"c:\Users\Jonathan\Desktop\breakfast-and-after-school-club\src\routes\update-password\title-and-loader.component.jsx", "JavaScript", 0, 0, 22, 0, 0, 0, 7, 29
"c:\Users\Jonathan\Desktop\breakfast-and-after-school-club\src\routes\update-password\update-password-button.component.jsx", "JavaScript", 0, 0, 37, 0, 0, 0, 11, 48
"c:\Users\Jonathan\Desktop\breakfast-and-after-school-club\src\routes\update-password\update-password-hooks\use-confirm-update-password.js", "JavaScript", 0, 0, 25, 0, 0, 0, 9, 34
"c:\Users\Jonathan\Desktop\breakfast-and-after-school-club\src\routes\update-password\update-password.component.jsx", "JavaScript", 0, 0, 19, 0, 0, 0, 6, 25
"c:\Users\Jonathan\Desktop\breakfast-and-after-school-club\src\routes\user-bookings\cancel-booking-button.component.jsx", "JavaScript", 0, 0, 27, 0, 0, 0, 4, 31
"c:\Users\Jonathan\Desktop\breakfast-and-after-school-club\src\routes\user-bookings\no-bookings-found.component.jsx", "JavaScript", 0, 0, 28, 0, 0, 0, 7, 35
"c:\Users\Jonathan\Desktop\breakfast-and-after-school-club\src\routes\user-bookings\table-columns.jsx", "JavaScript", 0, 0, 31, 0, 0, 0, 1, 32
"c:\Users\Jonathan\Desktop\breakfast-and-after-school-club\src\routes\user-bookings\user-bookings-hooks\use-cancel-booking-error-logic.js", "JavaScript", 0, 0, 36, 0, 0, 0, 7, 43
"c:\Users\Jonathan\Desktop\breakfast-and-after-school-club\src\routes\user-bookings\user-bookings-hooks\use-check-date-and-go-to-cancel-booking-route.js", "JavaScript", 0, 0, 36, 0, 0, 0, 10, 46
"c:\Users\Jonathan\Desktop\breakfast-and-after-school-club\src\routes\user-bookings\user-bookings-hooks\use-fire-error-swals.js", "JavaScript", 0, 0, 41, 0, 0, 0, 7, 48
"c:\Users\Jonathan\Desktop\breakfast-and-after-school-club\src\routes\user-bookings\user-bookings-hooks\use-get-user-bookings.js", "JavaScript", 0, 0, 21, 0, 0, 0, 8, 29
"c:\Users\Jonathan\Desktop\breakfast-and-after-school-club\src\routes\user-bookings\user-bookings-table.component.jsx", "JavaScript", 0, 0, 130, 0, 0, 0, 19, 149
"c:\Users\Jonathan\Desktop\breakfast-and-after-school-club\src\routes\user-bookings\users-bookings.component.jsx", "JavaScript", 0, 0, 24, 0, 0, 0, 11, 35
"c:\Users\Jonathan\Desktop\breakfast-and-after-school-club\src\routes\your-customer-bookings\2023-24-dates\23-24-dates.js", "JavaScript", 0, 0, 952, 0, 0, 0, 1, 953
"c:\Users\Jonathan\Desktop\breakfast-and-after-school-club\src\routes\your-customer-bookings\get-child-details-button.component.jsx", "JavaScript", 0, 0, 32, 0, 0, 0, 7, 39
"c:\Users\Jonathan\Desktop\breakfast-and-after-school-club\src\routes\your-customer-bookings\no-booking-data.found.component.jsx", "JavaScript", 0, 0, 53, 0, 0, 0, 8, 61
"c:\Users\Jonathan\Desktop\breakfast-and-after-school-club\src\routes\your-customer-bookings\table-columns.jsx", "JavaScript", 0, 0, 48, 0, 0, 0, 2, 50
"c:\Users\Jonathan\Desktop\breakfast-and-after-school-club\src\routes\your-customer-bookings\toggle-bookings-show-button.component.jsx", "JavaScript", 0, 0, 40, 0, 0, 0, 10, 50
"c:\Users\Jonathan\Desktop\breakfast-and-after-school-club\src\routes\your-customer-bookings\your-customer-bookings-hooks\use-confirm-upload-dates-to-database.js", "JavaScript", 0, 0, 28, 0, 0, 0, 12, 40
"c:\Users\Jonathan\Desktop\breakfast-and-after-school-club\src\routes\your-customer-bookings\your-customer-bookings-hooks\use-get-booked-sessions-listener.js", "JavaScript", 0, 0, 56, 0, 0, 3, 14, 73
"c:\Users\Jonathan\Desktop\breakfast-and-after-school-club\src\routes\your-customer-bookings\your-customer-bookings-hooks\use-get-booked-sessions.js", "JavaScript", 0, 0, 18, 0, 0, 0, 8, 26
"c:\Users\Jonathan\Desktop\breakfast-and-after-school-club\src\routes\your-customer-bookings\your-customer-bookings-hooks\use-upload-dates-to-database-swal.js", "JavaScript", 0, 0, 39, 0, 0, 0, 8, 47
"c:\Users\Jonathan\Desktop\breakfast-and-after-school-club\src\routes\your-customer-bookings\your-customer-bookings-table.component.jsx", "JavaScript", 0, 0, 169, 0, 0, 0, 22, 191
"c:\Users\Jonathan\Desktop\breakfast-and-after-school-club\src\routes\your-customer-bookings\your-customer-bookings.component.jsx", "JavaScript", 0, 0, 26, 0, 0, 0, 10, 36
"c:\Users\Jonathan\Desktop\breakfast-and-after-school-club\src\school-codes-list\school-codes-list.js", "JavaScript", 0, 0, 4, 0, 0, 0, 1, 5
"c:\Users\Jonathan\Desktop\breakfast-and-after-school-club\src\service-worker.js", "JavaScript", 0, 0, 38, 0, 0, 24, 12, 74
"c:\Users\Jonathan\Desktop\breakfast-and-after-school-club\src\serviceWorkerRegistration.js", "JavaScript", 0, 0, 101, 0, 0, 22, 10, 133
"c:\Users\Jonathan\Desktop\breakfast-and-after-school-club\src\store\add-child-info\add-child-info.slice.js", "JavaScript", 0, 0, 78, 0, 0, 0, 6, 84
"c:\Users\Jonathan\Desktop\breakfast-and-after-school-club\src\store\add-child-info\add-child-info.thunks.js", "JavaScript", 0, 0, 36, 0, 0, 0, 4, 40
"c:\Users\Jonathan\Desktop\breakfast-and-after-school-club\src\store\book-session\book-session.slice.js", "JavaScript", 0, 0, 156, 0, 0, 1, 8, 165
"c:\Users\Jonathan\Desktop\breakfast-and-after-school-club\src\store\book-session\book-session.thunks.js", "JavaScript", 0, 0, 227, 0, 0, 5, 30, 262
"c:\Users\Jonathan\Desktop\breakfast-and-after-school-club\src\store\booked-sessions\booked-sessions.slice.js", "JavaScript", 0, 0, 72, 0, 0, 0, 6, 78
"c:\Users\Jonathan\Desktop\breakfast-and-after-school-club\src\store\booked-sessions\booked-sessions.thunks.js", "JavaScript", 0, 0, 18, 0, 0, 0, 4, 22
"c:\Users\Jonathan\Desktop\breakfast-and-after-school-club\src\store\card-input-result\card-input-result.slice.js", "JavaScript", 0, 0, 35, 0, 0, 0, 5, 40
"c:\Users\Jonathan\Desktop\breakfast-and-after-school-club\src\store\choose-new-password\choose-new-password.slice.js", "JavaScript", 0, 0, 72, 0, 0, 0, 6, 78
"c:\Users\Jonathan\Desktop\breakfast-and-after-school-club\src\store\choose-new-password\choose-new-password.thunks.js", "JavaScript", 0, 0, 21, 0, 0, 0, 4, 25
"c:\Users\Jonathan\Desktop\breakfast-and-after-school-club\src\store\chosen-entry-child-details\chosen-entry-child-details.slice.js", "JavaScript", 0, 0, 61, 0, 0, 0, 5, 66
"c:\Users\Jonathan\Desktop\breakfast-and-after-school-club\src\store\chosen-entry-child-details\chosen-entry-child-details.thunks.js", "JavaScript", 0, 0, 27, 0, 0, 0, 7, 34
"c:\Users\Jonathan\Desktop\breakfast-and-after-school-club\src\store\contact-form\contact-form.slice.js", "JavaScript", 0, 0, 64, 0, 0, 0, 5, 69
"c:\Users\Jonathan\Desktop\breakfast-and-after-school-club\src\store\contact-form\contact-form.thunks.js", "JavaScript", 0, 0, 33, 0, 0, 0, 6, 39
"c:\Users\Jonathan\Desktop\breakfast-and-after-school-club\src\store\date-and-time\date-and-time.slice.js", "JavaScript", 0, 0, 30, 0, 0, 0, 6, 36
"c:\Users\Jonathan\Desktop\breakfast-and-after-school-club\src\store\delete-child-info\delete-child-info.slice.js", "JavaScript", 0, 0, 76, 0, 0, 0, 5, 81
"c:\Users\Jonathan\Desktop\breakfast-and-after-school-club\src\store\delete-child-info\delete-child-info.thunks.js", "JavaScript", 0, 0, 34, 0, 0, 0, 6, 40
"c:\Users\Jonathan\Desktop\breakfast-and-after-school-club\src\store\edit-child-info\edit-child-info.slice.js", "JavaScript", 0, 0, 75, 0, 0, 0, 5, 80
"c:\Users\Jonathan\Desktop\breakfast-and-after-school-club\src\store\edit-child-info\edit-child-info.thunks.js", "JavaScript", 0, 0, 33, 0, 0, 0, 6, 39
"c:\Users\Jonathan\Desktop\breakfast-and-after-school-club\src\store\generate-new-password-request\generate-new-password-request.slice.js", "JavaScript", 0, 0, 65, 0, 0, 0, 5, 70
"c:\Users\Jonathan\Desktop\breakfast-and-after-school-club\src\store\generate-new-password-request\generate-new-password-request.thunks.js", "JavaScript", 0, 0, 26, 0, 0, 0, 3, 29
"c:\Users\Jonathan\Desktop\breakfast-and-after-school-club\src\store\get-users-children\get-users-children.slice.js", "JavaScript", 0, 0, 60, 0, 0, 0, 5, 65
"c:\Users\Jonathan\Desktop\breakfast-and-after-school-club\src\store\get-users-children\get-users-children.thunks.js", "JavaScript", 0, 0, 22, 0, 0, 0, 5, 27
"c:\Users\Jonathan\Desktop\breakfast-and-after-school-club\src\store\hamburger-menu\hamburger-menu.slice.js", "JavaScript", 0, 0, 30, 0, 0, 0, 5, 35
"c:\Users\Jonathan\Desktop\breakfast-and-after-school-club\src\store\handle-payment\handle-payment.slice.js", "JavaScript", 0, 0, 118, 0, 0, 0, 5, 123
"c:\Users\Jonathan\Desktop\breakfast-and-after-school-club\src\store\handle-payment\handle-payment.thunks.js", "JavaScript", 0, 0, 69, 0, 0, 0, 9, 78
"c:\Users\Jonathan\Desktop\breakfast-and-after-school-club\src\store\is-online\is-online.slice.js", "JavaScript", 0, 0, 29, 0, 0, 0, 5, 34
"c:\Users\Jonathan\Desktop\breakfast-and-after-school-club\src\store\password-is-visible\password-is-visible.slice.js", "JavaScript", 0, 0, 101, 0, 0, 0, 5, 106
"c:\Users\Jonathan\Desktop\breakfast-and-after-school-club\src\store\progressive-image\progressive-image.slice.js", "JavaScript", 0, 0, 28, 0, 0, 0, 6, 34
"c:\Users\Jonathan\Desktop\breakfast-and-after-school-club\src\store\request-date-data\request-date-data.slice.js", "JavaScript", 0, 0, 134, 0, 0, 1, 6, 141
"c:\Users\Jonathan\Desktop\breakfast-and-after-school-club\src\store\request-date-data\request-date-data.thunks.js", "JavaScript", 0, 0, 103, 0, 0, 0, 14, 117
"c:\Users\Jonathan\Desktop\breakfast-and-after-school-club\src\store\root-reducer.js", "JavaScript", 0, 0, 61, 0, 0, 0, 3, 64
"c:\Users\Jonathan\Desktop\breakfast-and-after-school-club\src\store\send-email\send-email.slice.js", "JavaScript", 0, 0, 68, 0, 0, 0, 6, 74
"c:\Users\Jonathan\Desktop\breakfast-and-after-school-club\src\store\send-email\send-email.thunks.js", "JavaScript", 0, 0, 236, 0, 0, 0, 21, 257
"c:\Users\Jonathan\Desktop\breakfast-and-after-school-club\src\store\session-types-and-prices\session-types-and-prices.selector.js", "JavaScript", 0, 0, 63, 0, 0, 0, 12, 75
"c:\Users\Jonathan\Desktop\breakfast-and-after-school-club\src\store\session-types-and-prices\session-types-and-prices.slice.js", "JavaScript", 0, 0, 96, 0, 0, 0, 5, 101
"c:\Users\Jonathan\Desktop\breakfast-and-after-school-club\src\store\session-types-and-prices\session-types-and-prices.thunks.js", "JavaScript", 0, 0, 46, 0, 0, 0, 3, 49
"c:\Users\Jonathan\Desktop\breakfast-and-after-school-club\src\store\should-show-element\should-show-element.selector.js", "JavaScript", 0, 0, 10, 0, 0, 0, 4, 14
"c:\Users\Jonathan\Desktop\breakfast-and-after-school-club\src\store\should-show-element\should-show-element.slice.js", "JavaScript", 0, 0, 42, 0, 0, 0, 5, 47
"c:\Users\Jonathan\Desktop\breakfast-and-after-school-club\src\store\sign-in-form\sign-in-form.selector.js", "JavaScript", 0, 0, 6, 0, 0, 0, 3, 9
"c:\Users\Jonathan\Desktop\breakfast-and-after-school-club\src\store\sign-in-form\sign-in-form.slice.js", "JavaScript", 0, 0, 24, 0, 0, 0, 5, 29
"c:\Users\Jonathan\Desktop\breakfast-and-after-school-club\src\store\sign-up-form\sign-up-form.selector.js", "JavaScript", 0, 0, 6, 0, 0, 0, 3, 9
"c:\Users\Jonathan\Desktop\breakfast-and-after-school-club\src\store\sign-up-form\sign-up-form.slice.js", "JavaScript", 0, 0, 26, 0, 0, 0, 5, 31
"c:\Users\Jonathan\Desktop\breakfast-and-after-school-club\src\store\store.js", "JavaScript", 0, 0, 13, 0, 0, 0, 3, 16
"c:\Users\Jonathan\Desktop\breakfast-and-after-school-club\src\store\update-email\update-email.selector.js", "JavaScript", 0, 0, 18, 0, 0, 0, 6, 24
"c:\Users\Jonathan\Desktop\breakfast-and-after-school-club\src\store\update-email\update-email.slice.js", "JavaScript", 0, 0, 68, 0, 0, 0, 6, 74
"c:\Users\Jonathan\Desktop\breakfast-and-after-school-club\src\store\upload-dates-to-database\upload-dates-to-database.selector.js", "JavaScript", 0, 0, 15, 0, 0, 0, 5, 20
"c:\Users\Jonathan\Desktop\breakfast-and-after-school-club\src\store\upload-dates-to-database\upload-dates-to-database.slice.js", "JavaScript", 0, 0, 60, 0, 0, 0, 8, 68
"c:\Users\Jonathan\Desktop\breakfast-and-after-school-club\src\store\user-booking-to-delete\user-booking-to-delete.selector.js", "JavaScript", 0, 0, 22, 0, 0, 0, 7, 29
"c:\Users\Jonathan\Desktop\breakfast-and-after-school-club\src\store\user-booking-to-delete\user-booking-to-delete.slice.js", "JavaScript", 0, 0, 224, 0, 0, 0, 24, 248
"c:\Users\Jonathan\Desktop\breakfast-and-after-school-club\src\store\user-bookings\user-bookings.selector.js", "JavaScript", 0, 0, 33, 0, 0, 0, 10, 43
"c:\Users\Jonathan\Desktop\breakfast-and-after-school-club\src\store\user-bookings\user-bookings.slice.js", "JavaScript", 0, 0, 65, 0, 0, 0, 10, 75
"c:\Users\Jonathan\Desktop\breakfast-and-after-school-club\src\store\user\functions.js", "JavaScript", 0, 0, 69, 0, 0, 2, 14, 85
"c:\Users\Jonathan\Desktop\breakfast-and-after-school-club\src\store\user\user.selector.js", "JavaScript", 0, 0, 18, 0, 0, 0, 6, 24
"c:\Users\Jonathan\Desktop\breakfast-and-after-school-club\src\store\user\user.slice.js", "JavaScript", 0, 0, 98, 0, 0, 0, 7, 105
"c:\Users\Jonathan\Desktop\breakfast-and-after-school-club\src\store\user\user.thunks.js", "JavaScript", 0, 0, 84, 0, 0, 0, 14, 98
"c:\Users\Jonathan\Desktop\breakfast-and-after-school-club\src\store\wallet-funds-to-add\wallet-funds-to-add.selector.js", "JavaScript", 0, 0, 6, 0, 0, 0, 3, 9
"c:\Users\Jonathan\Desktop\breakfast-and-after-school-club\src\store\wallet-funds-to-add\wallet-funds-to-add.slice.js", "JavaScript", 0, 0, 19, 0, 0, 0, 5, 24
"c:\Users\Jonathan\Desktop\breakfast-and-after-school-club\src\strings\strings.js", "JavaScript", 0, 0, 275, 0, 0, 6, 11, 292
"c:\Users\Jonathan\Desktop\breakfast-and-after-school-club\src\styles\buttons\buttons.styles.jsx", "JavaScript", 0, 0, 257, 0, 0, 0, 43, 300
"c:\Users\Jonathan\Desktop\breakfast-and-after-school-club\src\styles\colors.js", "JavaScript", 0, 0, 28, 0, 0, 0, 1, 29
"c:\Users\Jonathan\Desktop\breakfast-and-after-school-club\src\styles\confirm.css", "CSS", 0, 31, 0, 0, 0, 0, 6, 37
"c:\Users\Jonathan\Desktop\breakfast-and-after-school-club\src\styles\container\container.styles.jsx", "JavaScript", 0, 0, 13, 0, 0, 0, 4, 17
"c:\Users\Jonathan\Desktop\breakfast-and-after-school-club\src\styles\div\div.styles.jsx", "JavaScript", 0, 0, 410, 0, 0, 5, 76, 491
"c:\Users\Jonathan\Desktop\breakfast-and-after-school-club\src\styles\form\form.styles.jsx", "JavaScript", 0, 0, 371, 0, 0, 7, 77, 455
"c:\Users\Jonathan\Desktop\breakfast-and-after-school-club\src\styles\h1\h1.styles.jsx", "JavaScript", 0, 0, 8, 0, 0, 0, 3, 11
"c:\Users\Jonathan\Desktop\breakfast-and-after-school-club\src\styles\h2\h2.styles.jsx", "JavaScript", 0, 0, 9, 0, 0, 0, 3, 12
"c:\Users\Jonathan\Desktop\breakfast-and-after-school-club\src\styles\hr\hr.styles.jsx", "JavaScript", 0, 0, 13, 0, 0, 0, 4, 17
"c:\Users\Jonathan\Desktop\breakfast-and-after-school-club\src\styles\image\image.styles.jsx", "JavaScript", 0, 0, 35, 0, 0, 0, 7, 42
"c:\Users\Jonathan\Desktop\breakfast-and-after-school-club\src\styles\link\link.styles.jsx", "JavaScript", 0, 0, 23, 0, 0, 0, 8, 31
"c:\Users\Jonathan\Desktop\breakfast-and-after-school-club\src\styles\p\p.styles.jsx", "JavaScript", 0, 0, 63, 0, 0, 0, 16, 79
"c:\Users\Jonathan\Desktop\breakfast-and-after-school-club\src\styles\span\span.styles.jsx", "JavaScript", 0, 0, 140, 0, 0, 0, 25, 165
"c:\Users\Jonathan\Desktop\breakfast-and-after-school-club\src\styles\svg\svg.styles.jsx", "JavaScript", 0, 0, 28, 0, 0, 0, 6, 34
"c:\Users\Jonathan\Desktop\breakfast-and-after-school-club\src\styles\tables\tables.styles.jsx", "JavaScript", 0, 0, 63, 0, 0, 0, 13, 76
"c:\Users\Jonathan\Desktop\breakfast-and-after-school-club\src\utils\appwrite\appwrite-config.js", "JavaScript", 0, 0, 16, 0, 0, 0, 5, 21
"c:\Users\Jonathan\Desktop\breakfast-and-after-school-club\src\utils\appwrite\appwrite-functions.js", "JavaScript", 0, 0, 52, 0, 0, 0, 4, 56
"c:\Users\Jonathan\Desktop\breakfast-and-after-school-club\vite.config.js", "JavaScript", 0, 0, 23, 0, 0, 5, 3, 31
"Total", "-", 21, 46, 16736, 222, 85, 113, 2868, 20091