"filename", "language", "JavaScript", "XML", "CSS", "JSON", "HTML", "comment", "blank", "total"
"/Users/jonathanoakes/Desktop/breakfast-and-afterschool-club/index.html", "HTML", 0, 0, 0, 0, 21, 0, 1, 22
"/Users/jonathanoakes/Desktop/breakfast-and-afterschool-club/netlify/functions/create-payment-intent.js", "JavaScript", 23, 0, 0, 0, 0, 0, 6, 29
"/Users/jonathanoakes/Desktop/breakfast-and-afterschool-club/netlify/functions/send-account-closure-message.js", "JavaScript", 24, 0, 0, 0, 0, 0, 5, 29
"/Users/jonathanoakes/Desktop/breakfast-and-afterschool-club/netlify/functions/send-contact-form-message.js", "JavaScript", 23, 0, 0, 0, 0, 0, 5, 28
"/Users/jonathanoakes/Desktop/breakfast-and-afterschool-club/package.json", "JSON", 0, 0, 0, 49, 0, 0, 1, 50
"/Users/jonathanoakes/Desktop/breakfast-and-afterschool-club/public/manifest.json", "JSON", 0, 0, 0, 32, 0, 0, 1, 33
"/Users/jonathanoakes/Desktop/breakfast-and-afterschool-club/src/App.css", "CSS", 0, 0, 3, 0, 0, 0, 1, 4
"/Users/jonathanoakes/Desktop/breakfast-and-afterschool-club/src/App.jsx", "JavaScript", 153, 0, 0, 0, 0, 0, 12, 165
"/Users/jonathanoakes/Desktop/breakfast-and-afterschool-club/src/assets/crayons.svg", "XML", 0, 152, 0, 0, 0, 0, 1, 153
"/Users/jonathanoakes/Desktop/breakfast-and-afterschool-club/src/assets/loader.svg", "XML", 0, 8, 0, 0, 0, 0, 0, 8
"/Users/jonathanoakes/Desktop/breakfast-and-afterschool-club/src/assets/pencil.svg", "XML", 0, 45, 0, 0, 0, 0, 1, 46
"/Users/jonathanoakes/Desktop/breakfast-and-afterschool-club/src/assets/stripe-logo.svg", "XML", 0, 1, 0, 0, 0, 4, 0, 5
"/Users/jonathanoakes/Desktop/breakfast-and-afterschool-club/src/components/custom-button/custom-button.component.jsx", "JavaScript", 5, 0, 0, 0, 0, 0, 3, 8
"/Users/jonathanoakes/Desktop/breakfast-and-afterschool-club/src/components/errors/error-fallback.component.jsx", "JavaScript", 8, 0, 0, 0, 0, 0, 3, 11
"/Users/jonathanoakes/Desktop/breakfast-and-afterschool-club/src/components/errors/network-error.component.jsx", "JavaScript", 39, 0, 0, 0, 0, 0, 8, 47
"/Users/jonathanoakes/Desktop/breakfast-and-afterschool-club/src/components/loader/loader.component.jsx", "JavaScript", 10, 0, 0, 0, 0, 0, 3, 13
"/Users/jonathanoakes/Desktop/breakfast-and-afterschool-club/src/components/magic-url-button/magic-url-button.component.jsx", "JavaScript", 19, 0, 0, 0, 0, 0, 6, 25
"/Users/jonathanoakes/Desktop/breakfast-and-afterschool-club/src/components/private-routes/private-routes.component.jsx", "JavaScript", 9, 0, 0, 0, 0, 0, 5, 14
"/Users/jonathanoakes/Desktop/breakfast-and-afterschool-club/src/components/progressive-image/progressive-image.component.jsx", "JavaScript", 26, 0, 0, 0, 0, 0, 7, 33
"/Users/jonathanoakes/Desktop/breakfast-and-afterschool-club/src/components/social-logins/sections/brave.component.jsx", "JavaScript", 22, 0, 0, 0, 0, 0, 3, 25
"/Users/jonathanoakes/Desktop/breakfast-and-afterschool-club/src/components/social-logins/sections/chrome.component.jsx", "JavaScript", 19, 0, 0, 0, 0, 0, 3, 22
"/Users/jonathanoakes/Desktop/breakfast-and-afterschool-club/src/components/social-logins/sections/firefox.component.jsx", "JavaScript", 18, 0, 0, 0, 0, 0, 3, 21
"/Users/jonathanoakes/Desktop/breakfast-and-afterschool-club/src/components/social-logins/sections/info.component.jsx", "JavaScript", 44, 0, 0, 0, 0, 0, 4, 48
"/Users/jonathanoakes/Desktop/breakfast-and-afterschool-club/src/components/social-logins/sections/safari.component.jsx", "JavaScript", 29, 0, 0, 0, 0, 0, 3, 32
"/Users/jonathanoakes/Desktop/breakfast-and-afterschool-club/src/components/social-logins/sections/troubleshooting.component.jsx", "JavaScript", 16, 0, 0, 0, 0, 0, 3, 19
"/Users/jonathanoakes/Desktop/breakfast-and-afterschool-club/src/components/social-logins/social-logins-info.component.jsx", "JavaScript", 49, 0, 0, 0, 0, 0, 8, 57
"/Users/jonathanoakes/Desktop/breakfast-and-afterschool-club/src/components/social-logins/social-logins.component.jsx", "JavaScript", 42, 0, 0, 0, 0, 0, 12, 54
"/Users/jonathanoakes/Desktop/breakfast-and-afterschool-club/src/components/wallet-balance/wallet-balance.component.jsx", "JavaScript", 19, 0, 0, 0, 0, 0, 5, 24
"/Users/jonathanoakes/Desktop/breakfast-and-afterschool-club/src/functions/capitalize-string.js", "JavaScript", 8, 0, 0, 0, 0, 0, 2, 10
"/Users/jonathanoakes/Desktop/breakfast-and-afterschool-club/src/functions/get-future-dates.js", "JavaScript", 4, 0, 0, 0, 0, 0, 2, 6
"/Users/jonathanoakes/Desktop/breakfast-and-afterschool-club/src/functions/open-email-link.js", "JavaScript", 7, 0, 0, 0, 0, 0, 3, 10
"/Users/jonathanoakes/Desktop/breakfast-and-afterschool-club/src/functions/validate-email.js", "JavaScript", 4, 0, 0, 0, 0, 0, 1, 5
"/Users/jonathanoakes/Desktop/breakfast-and-afterschool-club/src/global-styles.js", "JavaScript", 56, 0, 0, 0, 0, 0, 7, 63
"/Users/jonathanoakes/Desktop/breakfast-and-afterschool-club/src/hooks/use-confirm-swal.js", "JavaScript", 72, 0, 0, 0, 0, 0, 7, 79
"/Users/jonathanoakes/Desktop/breakfast-and-afterschool-club/src/hooks/use-fire-swal.js", "JavaScript", 33, 0, 0, 0, 0, 0, 5, 38
"/Users/jonathanoakes/Desktop/breakfast-and-afterschool-club/src/hooks/use-get-user-on-load.js", "JavaScript", 17, 0, 0, 0, 0, 0, 5, 22
"/Users/jonathanoakes/Desktop/breakfast-and-afterschool-club/src/hooks/use-hamburger-handler-navigate.js", "JavaScript", 32, 0, 0, 0, 0, 0, 10, 42
"/Users/jonathanoakes/Desktop/breakfast-and-afterschool-club/src/hooks/use-is-online.js", "JavaScript", 34, 0, 0, 0, 0, 0, 9, 43
"/Users/jonathanoakes/Desktop/breakfast-and-afterschool-club/src/hooks/use-is-route-with-nav-warning.js", "JavaScript", 11, 0, 0, 0, 0, 0, 6, 17
"/Users/jonathanoakes/Desktop/breakfast-and-afterschool-club/src/hooks/use-reset-store.js", "JavaScript", 84, 0, 0, 0, 0, 0, 7, 91
"/Users/jonathanoakes/Desktop/breakfast-and-afterschool-club/src/hooks/use-session-spaces-listener.js", "JavaScript", 35, 0, 0, 0, 0, 0, 9, 44
"/Users/jonathanoakes/Desktop/breakfast-and-afterschool-club/src/hooks/use-wallet-balance-listener.js", "JavaScript", 25, 0, 0, 0, 0, 0, 8, 33
"/Users/jonathanoakes/Desktop/breakfast-and-afterschool-club/src/index.css", "CSS", 0, 0, 12, 0, 0, 0, 2, 14
"/Users/jonathanoakes/Desktop/breakfast-and-afterschool-club/src/main.jsx", "JavaScript", 25, 0, 0, 0, 0, 0, 3, 28
"/Users/jonathanoakes/Desktop/breakfast-and-afterschool-club/src/routes/account/account-button-links.component.jsx", "JavaScript", 49, 0, 0, 0, 0, 0, 13, 62
"/Users/jonathanoakes/Desktop/breakfast-and-afterschool-club/src/routes/account/account-hooks/use-check-for-and-clear-form-details.js", "JavaScript", 44, 0, 0, 0, 0, 0, 8, 52
"/Users/jonathanoakes/Desktop/breakfast-and-afterschool-club/src/routes/account/account-hooks/use-navigate-to-route.js", "JavaScript", 34, 0, 0, 0, 0, 0, 10, 44
"/Users/jonathanoakes/Desktop/breakfast-and-afterschool-club/src/routes/account/account-stripe-logo.component.jsx", "JavaScript", 22, 0, 0, 0, 0, 0, 7, 29
"/Users/jonathanoakes/Desktop/breakfast-and-afterschool-club/src/routes/account/account.component.jsx", "JavaScript", 21, 0, 0, 0, 0, 0, 7, 28
"/Users/jonathanoakes/Desktop/breakfast-and-afterschool-club/src/routes/account/intro.component.jsx", "JavaScript", 16, 0, 0, 0, 0, 0, 7, 23
"/Users/jonathanoakes/Desktop/breakfast-and-afterschool-club/src/routes/add-funds/add-funds-button.component.jsx", "JavaScript", 18, 0, 0, 0, 0, 0, 5, 23
"/Users/jonathanoakes/Desktop/breakfast-and-afterschool-club/src/routes/add-funds/add-funds-hooks/use-clear-card-input-on-zero-wallet-funds.js", "JavaScript", 31, 0, 0, 0, 0, 0, 7, 38
"/Users/jonathanoakes/Desktop/breakfast-and-afterschool-club/src/routes/add-funds/add-funds-hooks/use-get-payment-result.js", "JavaScript", 86, 0, 0, 0, 0, 0, 15, 101
"/Users/jonathanoakes/Desktop/breakfast-and-afterschool-club/src/routes/add-funds/add-funds-hooks/use-handle-card-input-change.js", "JavaScript", 35, 0, 0, 0, 0, 0, 6, 41
"/Users/jonathanoakes/Desktop/breakfast-and-afterschool-club/src/routes/add-funds/add-funds-hooks/use-handle-wallet-funds-change.js", "JavaScript", 19, 0, 0, 0, 0, 0, 8, 27
"/Users/jonathanoakes/Desktop/breakfast-and-afterschool-club/src/routes/add-funds/add-funds-hooks/use-should-show-add-funds-button.component.js", "JavaScript", 19, 0, 0, 0, 0, 0, 7, 26
"/Users/jonathanoakes/Desktop/breakfast-and-afterschool-club/src/routes/add-funds/add-funds.component.jsx", "JavaScript", 25, 0, 0, 0, 0, 0, 8, 33
"/Users/jonathanoakes/Desktop/breakfast-and-afterschool-club/src/routes/add-funds/card-input-styles/card-input-styles.js", "JavaScript", 20, 0, 0, 0, 0, 0, 1, 21
"/Users/jonathanoakes/Desktop/breakfast-and-afterschool-club/src/routes/add-funds/card-input.component.jsx", "JavaScript", 35, 0, 0, 0, 0, 0, 10, 45
"/Users/jonathanoakes/Desktop/breakfast-and-afterschool-club/src/routes/add-funds/choose-wallet-funds-to-add.component.jsx", "JavaScript", 27, 0, 0, 0, 0, 0, 9, 36
"/Users/jonathanoakes/Desktop/breakfast-and-afterschool-club/src/routes/add-funds/errors-help-redirect/add-funds-error.component.jsx", "JavaScript", 40, 0, 0, 0, 0, 0, 7, 47
"/Users/jonathanoakes/Desktop/breakfast-and-afterschool-club/src/routes/add-funds/errors-help-redirect/add-funds-help.component.jsx", "JavaScript", 56, 0, 0, 0, 0, 0, 7, 63
"/Users/jonathanoakes/Desktop/breakfast-and-afterschool-club/src/routes/add-funds/errors-help-redirect/card-input-errors.component.jsx", "JavaScript", 24, 0, 0, 0, 0, 0, 8, 32
"/Users/jonathanoakes/Desktop/breakfast-and-afterschool-club/src/routes/add-funds/errors-help-redirect/redirect-and-loader.component.jsx", "JavaScript", 21, 0, 0, 0, 0, 0, 7, 28
"/Users/jonathanoakes/Desktop/breakfast-and-afterschool-club/src/routes/book-a-session/book-a-session-hooks/return-logic-and-reset-state/use-reset-state-and-navigate.js", "JavaScript", 19, 0, 0, 0, 0, 0, 6, 25
"/Users/jonathanoakes/Desktop/breakfast-and-afterschool-club/src/routes/book-a-session/book-a-session-hooks/return-logic-and-reset-state/use-return-logic.js", "JavaScript", 37, 0, 0, 0, 0, 0, 9, 46
"/Users/jonathanoakes/Desktop/breakfast-and-afterschool-club/src/routes/book-a-session/book-a-session-hooks/swals/use-get-book-session-result-swal.js", "JavaScript", 46, 0, 0, 0, 0, 0, 9, 55
"/Users/jonathanoakes/Desktop/breakfast-and-afterschool-club/src/routes/book-a-session/book-a-session-hooks/swals/use-success-swal.js", "JavaScript", 27, 0, 0, 0, 0, 0, 6, 33
"/Users/jonathanoakes/Desktop/breakfast-and-afterschool-club/src/routes/book-a-session/book-a-session-hooks/swals/use-update-balance-error-reset-session-doc-swal.js", "JavaScript", 60, 0, 0, 0, 0, 0, 10, 70
"/Users/jonathanoakes/Desktop/breakfast-and-afterschool-club/src/routes/book-a-session/book-a-session-hooks/swals/use-update-session-doc-error-swal.js", "JavaScript", 30, 0, 0, 0, 0, 0, 9, 39
"/Users/jonathanoakes/Desktop/breakfast-and-afterschool-club/src/routes/book-a-session/book-a-session-hooks/use-check-spaces-available-and-balance.js", "JavaScript", 68, 0, 0, 0, 0, 0, 14, 82
"/Users/jonathanoakes/Desktop/breakfast-and-afterschool-club/src/routes/book-a-session/book-a-session-hooks/use-choose-date-handle-change.js", "JavaScript", 10, 0, 0, 0, 0, 0, 6, 16
"/Users/jonathanoakes/Desktop/breakfast-and-afterschool-club/src/routes/book-a-session/book-a-session-hooks/use-confirm-book-session.js", "JavaScript", 40, 0, 0, 0, 0, 0, 11, 51
"/Users/jonathanoakes/Desktop/breakfast-and-afterschool-club/src/routes/book-a-session/book-a-session-hooks/use-confirm-session.js", "JavaScript", 13, 0, 0, 0, 0, 0, 7, 20
"/Users/jonathanoakes/Desktop/breakfast-and-afterschool-club/src/routes/book-a-session/book-a-session-hooks/use-get-request-date-data-values.js", "JavaScript", 14, 0, 0, 0, 0, 0, 6, 20
"/Users/jonathanoakes/Desktop/breakfast-and-afterschool-club/src/routes/book-a-session/book-a-session-hooks/use-request-date-data.js", "JavaScript", 13, 0, 0, 0, 0, 0, 5, 18
"/Users/jonathanoakes/Desktop/breakfast-and-afterschool-club/src/routes/book-a-session/book-a-session.component.jsx", "JavaScript", 32, 0, 0, 0, 0, 0, 12, 44
"/Users/jonathanoakes/Desktop/breakfast-and-afterschool-club/src/routes/book-a-session/sections/balance-check-and-book-session-help.component.jsx", "JavaScript", 77, 0, 0, 0, 0, 0, 9, 86
"/Users/jonathanoakes/Desktop/breakfast-and-afterschool-club/src/routes/book-a-session/sections/buttons/afternoon-session-long-button.component.jsx", "JavaScript", 30, 0, 0, 0, 0, 0, 9, 39
"/Users/jonathanoakes/Desktop/breakfast-and-afterschool-club/src/routes/book-a-session/sections/buttons/afternoon-session-short-button.component.jsx", "JavaScript", 26, 0, 0, 0, 0, 0, 8, 34
"/Users/jonathanoakes/Desktop/breakfast-and-afterschool-club/src/routes/book-a-session/sections/buttons/morning-and-afternoon-session-long-button.component.jsx", "JavaScript", 30, 0, 0, 0, 0, 0, 8, 38
"/Users/jonathanoakes/Desktop/breakfast-and-afterschool-club/src/routes/book-a-session/sections/buttons/morning-and-afternoon-session-short-button.component.jsx", "JavaScript", 30, 0, 0, 0, 0, 0, 9, 39
"/Users/jonathanoakes/Desktop/breakfast-and-afterschool-club/src/routes/book-a-session/sections/buttons/morning-session-button.component.jsx", "JavaScript", 26, 0, 0, 0, 0, 0, 8, 34
"/Users/jonathanoakes/Desktop/breakfast-and-afterschool-club/src/routes/book-a-session/sections/choose-date.component.jsx", "JavaScript", 38, 0, 0, 0, 0, 0, 12, 50
"/Users/jonathanoakes/Desktop/breakfast-and-afterschool-club/src/routes/book-a-session/sections/choose-sessions.component.jsx", "JavaScript", 44, 0, 0, 0, 0, 0, 7, 51
"/Users/jonathanoakes/Desktop/breakfast-and-afterschool-club/src/routes/book-a-session/sections/date-errors.component.jsx", "JavaScript", 38, 0, 0, 0, 0, 0, 9, 47
"/Users/jonathanoakes/Desktop/breakfast-and-afterschool-club/src/routes/book-a-session/sections/options-available-info.component.jsx", "JavaScript", 16, 0, 0, 0, 0, 0, 4, 20
"/Users/jonathanoakes/Desktop/breakfast-and-afterschool-club/src/routes/book-a-session/sections/spaces-available-info.component.jsx", "JavaScript", 52, 0, 0, 0, 0, 0, 8, 60
"/Users/jonathanoakes/Desktop/breakfast-and-afterschool-club/src/routes/book-a-session/sections/times-and-prices-accordion.component.jsx", "JavaScript", 79, 0, 0, 0, 0, 1, 8, 88
"/Users/jonathanoakes/Desktop/breakfast-and-afterschool-club/src/routes/close-account/close-account-hooks/use-account-closure-email.js", "JavaScript", 19, 0, 0, 0, 0, 0, 15, 34
"/Users/jonathanoakes/Desktop/breakfast-and-afterschool-club/src/routes/close-account/close-account-hooks/use-close-account-swal.js", "JavaScript", 64, 0, 0, 0, 0, 0, 9, 73
"/Users/jonathanoakes/Desktop/breakfast-and-afterschool-club/src/routes/close-account/close-account-hooks/use-confirm-close-account.js", "JavaScript", 44, 0, 0, 0, 0, 0, 11, 55
"/Users/jonathanoakes/Desktop/breakfast-and-afterschool-club/src/routes/close-account/close-account.component.jsx", "JavaScript", 61, 0, 0, 0, 0, 0, 12, 73
"/Users/jonathanoakes/Desktop/breakfast-and-afterschool-club/src/routes/contact/contact-form-hooks/use-confirm-send-contact-form-message.js", "JavaScript", 35, 0, 0, 0, 0, 0, 11, 46
"/Users/jonathanoakes/Desktop/breakfast-and-afterschool-club/src/routes/contact/contact-form-hooks/use-handle-contact-form-details-change.js", "JavaScript", 13, 0, 0, 0, 0, 0, 6, 19
"/Users/jonathanoakes/Desktop/breakfast-and-afterschool-club/src/routes/contact/contact-form-hooks/use-send-contact-form-message-result-swal.js", "JavaScript", 53, 0, 0, 0, 0, 0, 7, 60
"/Users/jonathanoakes/Desktop/breakfast-and-afterschool-club/src/routes/contact/contact.component.jsx", "JavaScript", 22, 0, 0, 0, 0, 0, 11, 33
"/Users/jonathanoakes/Desktop/breakfast-and-afterschool-club/src/routes/contact/sections/contact-form.component.jsx", "JavaScript", 58, 0, 0, 0, 0, 0, 14, 72
"/Users/jonathanoakes/Desktop/breakfast-and-afterschool-club/src/routes/contact/sections/send-message-button.component.jsx", "JavaScript", 36, 0, 0, 0, 0, 0, 10, 46
"/Users/jonathanoakes/Desktop/breakfast-and-afterschool-club/src/routes/dashboard/2023-24-dates/23-24-dates.js", "JavaScript", 952, 0, 0, 0, 0, 0, 1, 953
"/Users/jonathanoakes/Desktop/breakfast-and-afterschool-club/src/routes/dashboard/dashboard-hooks/use-confirm-upload-dates-to-database.js", "JavaScript", 24, 0, 0, 0, 0, 0, 11, 35
"/Users/jonathanoakes/Desktop/breakfast-and-afterschool-club/src/routes/dashboard/dashboard-hooks/use-upload-dates-to-database-swal.js", "JavaScript", 39, 0, 0, 0, 0, 0, 8, 47
"/Users/jonathanoakes/Desktop/breakfast-and-afterschool-club/src/routes/dashboard/dashboard.component.jsx", "JavaScript", 17, 0, 0, 0, 0, 0, 4, 21
"/Users/jonathanoakes/Desktop/breakfast-and-afterschool-club/src/routes/forgot-password-request/forgot-password-request-hooks/use-forgot-password-request-swal.js", "JavaScript", 60, 0, 0, 0, 0, 0, 9, 69
"/Users/jonathanoakes/Desktop/breakfast-and-afterschool-club/src/routes/forgot-password-request/forgot-password-request-hooks/use-handle-forgot-password-request-email-change.js", "JavaScript", 10, 0, 0, 0, 0, 0, 6, 16
"/Users/jonathanoakes/Desktop/breakfast-and-afterschool-club/src/routes/forgot-password-request/forgot-password-request.component.jsx", "JavaScript", 68, 0, 0, 0, 0, 0, 14, 82
"/Users/jonathanoakes/Desktop/breakfast-and-afterschool-club/src/routes/forgot-password-result/forgot-password-result-hooks/use-confirm-reset-password.js", "JavaScript", 43, 0, 0, 0, 0, 0, 10, 53
"/Users/jonathanoakes/Desktop/breakfast-and-afterschool-club/src/routes/forgot-password-result/forgot-password-result-hooks/use-forgot-password-result-swal.js", "JavaScript", 54, 0, 0, 0, 0, 0, 11, 65
"/Users/jonathanoakes/Desktop/breakfast-and-afterschool-club/src/routes/forgot-password-result/forgot-password-result-hooks/use-handle-reset-password-form-change.js", "JavaScript", 13, 0, 0, 0, 0, 0, 6, 19
"/Users/jonathanoakes/Desktop/breakfast-and-afterschool-club/src/routes/forgot-password-result/forgot-password-result-hooks/use-hide-reset-password-fields-on-empty.js", "JavaScript", 37, 0, 0, 0, 0, 0, 6, 43
"/Users/jonathanoakes/Desktop/breakfast-and-afterschool-club/src/routes/forgot-password-result/forgot-password-result.component.jsx", "JavaScript", 27, 0, 0, 0, 0, 0, 11, 38
"/Users/jonathanoakes/Desktop/breakfast-and-afterschool-club/src/routes/forgot-password-result/sections/intro.component.jsx", "JavaScript", 20, 0, 0, 0, 0, 0, 5, 25
"/Users/jonathanoakes/Desktop/breakfast-and-afterschool-club/src/routes/forgot-password-result/sections/new-passwords.component.jsx", "JavaScript", 74, 0, 0, 0, 0, 0, 13, 87
"/Users/jonathanoakes/Desktop/breakfast-and-afterschool-club/src/routes/forgot-password-result/sections/reset-password-button.component.jsx", "JavaScript", 29, 0, 0, 0, 0, 0, 9, 38
"/Users/jonathanoakes/Desktop/breakfast-and-afterschool-club/src/routes/home/home.component.jsx", "JavaScript", 12, 0, 0, 0, 0, 0, 4, 16
"/Users/jonathanoakes/Desktop/breakfast-and-afterschool-club/src/routes/home/info.component.jsx", "JavaScript", 21, 0, 0, 0, 0, 0, 3, 24
"/Users/jonathanoakes/Desktop/breakfast-and-afterschool-club/src/routes/home/intro.component.jsx", "JavaScript", 19, 0, 0, 0, 0, 0, 4, 23
"/Users/jonathanoakes/Desktop/breakfast-and-afterschool-club/src/routes/home/links.component.jsx", "JavaScript", 25, 0, 0, 0, 0, 0, 5, 30
"/Users/jonathanoakes/Desktop/breakfast-and-afterschool-club/src/routes/magic-url-request/magic-url-request-hooks/use-confirm-request-magic-url.js", "JavaScript", 26, 0, 0, 0, 0, 0, 9, 35
"/Users/jonathanoakes/Desktop/breakfast-and-afterschool-club/src/routes/magic-url-request/magic-url-request-hooks/use-handle-magic-url-email-change.js", "JavaScript", 10, 0, 0, 0, 0, 0, 6, 16
"/Users/jonathanoakes/Desktop/breakfast-and-afterschool-club/src/routes/magic-url-request/magic-url-request-hooks/use-magic-url-request-swal.js", "JavaScript", 48, 0, 0, 0, 0, 0, 9, 57
"/Users/jonathanoakes/Desktop/breakfast-and-afterschool-club/src/routes/magic-url-request/magic-url-request-info.component.jsx", "JavaScript", 97, 0, 0, 0, 0, 0, 7, 104
"/Users/jonathanoakes/Desktop/breakfast-and-afterschool-club/src/routes/magic-url-request/magic-url-request.component.jsx", "JavaScript", 53, 0, 0, 0, 0, 0, 13, 66
"/Users/jonathanoakes/Desktop/breakfast-and-afterschool-club/src/routes/magic-url-result/magic-url-result.component.jsx", "JavaScript", 69, 0, 0, 0, 0, 0, 13, 82
"/Users/jonathanoakes/Desktop/breakfast-and-afterschool-club/src/routes/magic-url-result/use-get-magic-url-result.js", "JavaScript", 14, 0, 0, 0, 0, 0, 5, 19
"/Users/jonathanoakes/Desktop/breakfast-and-afterschool-club/src/routes/navigation/nav-app-owner.component.jsx", "JavaScript", 33, 0, 0, 0, 0, 0, 9, 42
"/Users/jonathanoakes/Desktop/breakfast-and-afterschool-club/src/routes/navigation/nav-hamburger.component.jsx", "JavaScript", 36, 0, 0, 0, 0, 0, 6, 42
"/Users/jonathanoakes/Desktop/breakfast-and-afterschool-club/src/routes/navigation/nav-logo.component.jsx", "JavaScript", 17, 0, 0, 0, 0, 0, 6, 23
"/Users/jonathanoakes/Desktop/breakfast-and-afterschool-club/src/routes/navigation/nav-no-user.component.jsx", "JavaScript", 33, 0, 0, 0, 0, 0, 9, 42
"/Users/jonathanoakes/Desktop/breakfast-and-afterschool-club/src/routes/navigation/nav-not-app-owner.component.jsx", "JavaScript", 68, 0, 0, 0, 0, 0, 11, 79
"/Users/jonathanoakes/Desktop/breakfast-and-afterschool-club/src/routes/navigation/nav-sign-out.component.jsx", "JavaScript", 59, 0, 0, 0, 0, 0, 13, 72
"/Users/jonathanoakes/Desktop/breakfast-and-afterschool-club/src/routes/navigation/navigation-hooks/use-get-sign-out-error.js", "JavaScript", 35, 0, 0, 0, 0, 0, 10, 45
"/Users/jonathanoakes/Desktop/breakfast-and-afterschool-club/src/routes/navigation/navigation.component.jsx", "JavaScript", 41, 0, 0, 0, 0, 0, 9, 50
"/Users/jonathanoakes/Desktop/breakfast-and-afterschool-club/src/routes/navigation/routes.js", "JavaScript", 25, 0, 0, 0, 0, 0, 4, 29
"/Users/jonathanoakes/Desktop/breakfast-and-afterschool-club/src/routes/payment-result/payment-result-hooks/use-get-upload-result.js", "JavaScript", 75, 0, 0, 0, 0, 0, 13, 88
"/Users/jonathanoakes/Desktop/breakfast-and-afterschool-club/src/routes/payment-result/payment-result-hooks/use-handle-payment-failed.js", "JavaScript", 37, 0, 0, 0, 0, 0, 9, 46
"/Users/jonathanoakes/Desktop/breakfast-and-afterschool-club/src/routes/payment-result/payment-result-hooks/use-handle-payment-succeeded.js", "JavaScript", 41, 0, 0, 0, 0, 0, 8, 49
"/Users/jonathanoakes/Desktop/breakfast-and-afterschool-club/src/routes/payment-result/payment-result.component.jsx", "JavaScript", 24, 0, 0, 0, 0, 0, 11, 35
"/Users/jonathanoakes/Desktop/breakfast-and-afterschool-club/src/routes/sign-in/sections/sign-in-button.component.jsx", "JavaScript", 30, 0, 0, 0, 0, 0, 8, 38
"/Users/jonathanoakes/Desktop/breakfast-and-afterschool-club/src/routes/sign-in/sections/sign-in-email.component.jsx", "JavaScript", 20, 0, 0, 0, 0, 0, 7, 27
"/Users/jonathanoakes/Desktop/breakfast-and-afterschool-club/src/routes/sign-in/sections/sign-in-password.component.jsx", "JavaScript", 36, 0, 0, 0, 0, 0, 11, 47
"/Users/jonathanoakes/Desktop/breakfast-and-afterschool-club/src/routes/sign-in/sign-in-form-hooks/use-handle-sign-in-form-change.js", "JavaScript", 13, 0, 0, 0, 0, 0, 6, 19
"/Users/jonathanoakes/Desktop/breakfast-and-afterschool-club/src/routes/sign-in/sign-in-form-hooks/use-handle-sign-in-form-error.js", "JavaScript", 20, 0, 0, 0, 0, 0, 8, 28
"/Users/jonathanoakes/Desktop/breakfast-and-afterschool-club/src/routes/sign-in/sign-in-form-hooks/use-handle-sign-in-form-submit.js", "JavaScript", 26, 0, 0, 0, 0, 0, 10, 36
"/Users/jonathanoakes/Desktop/breakfast-and-afterschool-club/src/routes/sign-in/sign-in-form-hooks/use-hide-sign-in-password-on-empty.js", "JavaScript", 17, 0, 0, 0, 0, 0, 8, 25
"/Users/jonathanoakes/Desktop/breakfast-and-afterschool-club/src/routes/sign-in/sign-in.component.jsx", "JavaScript", 53, 0, 0, 0, 0, 0, 13, 66
"/Users/jonathanoakes/Desktop/breakfast-and-afterschool-club/src/routes/sign-up/sections/sign-up-button.component.jsx", "JavaScript", 25, 0, 0, 0, 0, 0, 5, 30
"/Users/jonathanoakes/Desktop/breakfast-and-afterschool-club/src/routes/sign-up/sections/sign-up-email.component.jsx", "JavaScript", 16, 0, 0, 0, 0, 0, 3, 19
"/Users/jonathanoakes/Desktop/breakfast-and-afterschool-club/src/routes/sign-up/sections/sign-up-name.component.jsx", "JavaScript", 16, 0, 0, 0, 0, 0, 3, 19
"/Users/jonathanoakes/Desktop/breakfast-and-afterschool-club/src/routes/sign-up/sections/sign-up-passwords.component.jsx", "JavaScript", 73, 0, 0, 0, 0, 0, 13, 86
"/Users/jonathanoakes/Desktop/breakfast-and-afterschool-club/src/routes/sign-up/sign-up-form-hooks/use-handle-sign-up-form-change.js", "JavaScript", 13, 0, 0, 0, 0, 0, 6, 19
"/Users/jonathanoakes/Desktop/breakfast-and-afterschool-club/src/routes/sign-up/sign-up-form-hooks/use-handle-sign-up-form-error.js", "JavaScript", 20, 0, 0, 0, 0, 0, 7, 27
"/Users/jonathanoakes/Desktop/breakfast-and-afterschool-club/src/routes/sign-up/sign-up-form-hooks/use-handle-sign-up-form-submit.js", "JavaScript", 29, 0, 0, 0, 0, 0, 10, 39
"/Users/jonathanoakes/Desktop/breakfast-and-afterschool-club/src/routes/sign-up/sign-up-form-hooks/use-hide-sign-up-password-on-empty.js", "JavaScript", 34, 0, 0, 0, 0, 0, 7, 41
"/Users/jonathanoakes/Desktop/breakfast-and-afterschool-club/src/routes/sign-up/sign-up.component.jsx", "JavaScript", 59, 0, 0, 0, 0, 0, 13, 72
"/Users/jonathanoakes/Desktop/breakfast-and-afterschool-club/src/routes/social-login-result/navigate-and-loader.component.jsx", "JavaScript", 19, 0, 0, 0, 0, 0, 7, 26
"/Users/jonathanoakes/Desktop/breakfast-and-afterschool-club/src/routes/social-login-result/social-login-error.component.jsx", "JavaScript", 56, 0, 0, 0, 0, 0, 19, 75
"/Users/jonathanoakes/Desktop/breakfast-and-afterschool-club/src/routes/social-login-result/social-login-hooks/use-nav-and-reset-error.js", "JavaScript", 26, 0, 0, 0, 0, 0, 8, 34
"/Users/jonathanoakes/Desktop/breakfast-and-afterschool-club/src/routes/social-login-result/social-login-result.component.jsx", "JavaScript", 17, 0, 0, 0, 0, 0, 4, 21
"/Users/jonathanoakes/Desktop/breakfast-and-afterschool-club/src/routes/social-login-result/social-login-success.component.jsx", "JavaScript", 18, 0, 0, 0, 0, 0, 6, 24
"/Users/jonathanoakes/Desktop/breakfast-and-afterschool-club/src/routes/update-email/info.component.jsx", "JavaScript", 55, 0, 0, 0, 0, 0, 8, 63
"/Users/jonathanoakes/Desktop/breakfast-and-afterschool-club/src/routes/update-email/new-email.component.jsx", "JavaScript", 74, 0, 0, 0, 0, 0, 13, 87
"/Users/jonathanoakes/Desktop/breakfast-and-afterschool-club/src/routes/update-email/title-and-loader.component.jsx", "JavaScript", 20, 0, 0, 0, 0, 0, 7, 27
"/Users/jonathanoakes/Desktop/breakfast-and-afterschool-club/src/routes/update-email/update-email-hooks/use-confirm-update-email.js", "JavaScript", 49, 0, 0, 0, 0, 0, 12, 61
"/Users/jonathanoakes/Desktop/breakfast-and-afterschool-club/src/routes/update-email/update-email-hooks/use-handle-update-email-details.js", "JavaScript", 13, 0, 0, 0, 0, 0, 6, 19
"/Users/jonathanoakes/Desktop/breakfast-and-afterschool-club/src/routes/update-email/update-email-hooks/use-hide-update-email-password-on-empty.js", "JavaScript", 19, 0, 0, 0, 0, 0, 7, 26
"/Users/jonathanoakes/Desktop/breakfast-and-afterschool-club/src/routes/update-email/update-email-hooks/use-update-email-result-swal.js", "JavaScript", 73, 0, 0, 0, 0, 0, 10, 83
"/Users/jonathanoakes/Desktop/breakfast-and-afterschool-club/src/routes/update-email/update-email.component.jsx", "JavaScript", 19, 0, 0, 0, 0, 0, 7, 26
"/Users/jonathanoakes/Desktop/breakfast-and-afterschool-club/src/routes/update-password-request/info.component.jsx", "JavaScript", 52, 0, 0, 0, 0, 0, 8, 60
"/Users/jonathanoakes/Desktop/breakfast-and-afterschool-club/src/routes/update-password-request/title-and-loader.component.jsx", "JavaScript", 20, 0, 0, 0, 0, 0, 7, 27
"/Users/jonathanoakes/Desktop/breakfast-and-afterschool-club/src/routes/update-password-request/update-password-request-button.component.jsx", "JavaScript", 48, 0, 0, 0, 0, 0, 13, 61
"/Users/jonathanoakes/Desktop/breakfast-and-afterschool-club/src/routes/update-password-request/update-password-request-hooks/use-confirm-update-password-request.js", "JavaScript", 27, 0, 0, 0, 0, 0, 11, 38
"/Users/jonathanoakes/Desktop/breakfast-and-afterschool-club/src/routes/update-password-request/update-password-request-hooks/use-update-password-request-result-swal.js", "JavaScript", 53, 0, 0, 0, 0, 0, 10, 63
"/Users/jonathanoakes/Desktop/breakfast-and-afterschool-club/src/routes/update-password-request/update-password-request.component.jsx", "JavaScript", 19, 0, 0, 0, 0, 0, 6, 25
"/Users/jonathanoakes/Desktop/breakfast-and-afterschool-club/src/routes/update-password-result/new-passwords.component.jsx", "JavaScript", 73, 0, 0, 0, 0, 0, 13, 86
"/Users/jonathanoakes/Desktop/breakfast-and-afterschool-club/src/routes/update-password-result/title-loader-info.component.jsx", "JavaScript", 25, 0, 0, 0, 0, 0, 8, 33
"/Users/jonathanoakes/Desktop/breakfast-and-afterschool-club/src/routes/update-password-result/update-password-button.component.jsx", "JavaScript", 32, 0, 0, 0, 0, 0, 9, 41
"/Users/jonathanoakes/Desktop/breakfast-and-afterschool-club/src/routes/update-password-result/update-password-result-hooks/use-confirm-update-password.js", "JavaScript", 55, 0, 0, 0, 0, 0, 12, 67
"/Users/jonathanoakes/Desktop/breakfast-and-afterschool-club/src/routes/update-password-result/update-password-result-hooks/use-handle-update-password-form-change.js", "JavaScript", 15, 0, 0, 0, 0, 0, 6, 21
"/Users/jonathanoakes/Desktop/breakfast-and-afterschool-club/src/routes/update-password-result/update-password-result-hooks/use-hide-update-password-field-on-empty.js", "JavaScript", 38, 0, 0, 0, 0, 0, 6, 44
"/Users/jonathanoakes/Desktop/breakfast-and-afterschool-club/src/routes/update-password-result/update-password-result-hooks/use-update-password-result-swal.js", "JavaScript", 79, 0, 0, 0, 0, 0, 11, 90
"/Users/jonathanoakes/Desktop/breakfast-and-afterschool-club/src/routes/update-password-result/update-password-result.component.jsx", "JavaScript", 22, 0, 0, 0, 0, 0, 6, 28
"/Users/jonathanoakes/Desktop/breakfast-and-afterschool-club/src/service-worker.js", "JavaScript", 38, 0, 0, 0, 0, 24, 12, 74
"/Users/jonathanoakes/Desktop/breakfast-and-afterschool-club/src/serviceWorkerRegistration.js", "JavaScript", 101, 0, 0, 0, 0, 22, 10, 133
"/Users/jonathanoakes/Desktop/breakfast-and-afterschool-club/src/session-prices/session-prices.js", "JavaScript", 5, 0, 0, 0, 0, 0, 1, 6
"/Users/jonathanoakes/Desktop/breakfast-and-afterschool-club/src/store/book-session/book-session-thunks.js", "JavaScript", 121, 0, 0, 0, 0, 0, 15, 136
"/Users/jonathanoakes/Desktop/breakfast-and-afterschool-club/src/store/book-session/book-session.selector.js", "JavaScript", 22, 0, 0, 0, 0, 0, 7, 29
"/Users/jonathanoakes/Desktop/breakfast-and-afterschool-club/src/store/book-session/book-session.slice.js", "JavaScript", 87, 0, 0, 0, 0, 0, 8, 95
"/Users/jonathanoakes/Desktop/breakfast-and-afterschool-club/src/store/card-input-result/card-input-result.selector.js", "JavaScript", 6, 0, 0, 0, 0, 0, 3, 9
"/Users/jonathanoakes/Desktop/breakfast-and-afterschool-club/src/store/card-input-result/card-input-result.slice.js", "JavaScript", 24, 0, 0, 0, 0, 0, 5, 29
"/Users/jonathanoakes/Desktop/breakfast-and-afterschool-club/src/store/close-account/close-account.selector.js", "JavaScript", 14, 0, 0, 0, 0, 0, 5, 19
"/Users/jonathanoakes/Desktop/breakfast-and-afterschool-club/src/store/close-account/close-account.slice.js", "JavaScript", 52, 0, 0, 0, 0, 0, 7, 59
"/Users/jonathanoakes/Desktop/breakfast-and-afterschool-club/src/store/contact-form/contact-form.selector.js", "JavaScript", 18, 0, 0, 0, 0, 0, 6, 24
"/Users/jonathanoakes/Desktop/breakfast-and-afterschool-club/src/store/contact-form/contact-form.slice.js", "JavaScript", 75, 0, 0, 0, 0, 0, 8, 83
"/Users/jonathanoakes/Desktop/breakfast-and-afterschool-club/src/store/contact-form/email-to-send.js", "JavaScript", 16, 0, 0, 0, 0, 0, 5, 21
"/Users/jonathanoakes/Desktop/breakfast-and-afterschool-club/src/store/forgot-password-request/forgot-password-request.selector.js", "JavaScript", 20, 0, 0, 0, 0, 0, 6, 26
"/Users/jonathanoakes/Desktop/breakfast-and-afterschool-club/src/store/forgot-password-request/forgot-password-request.slice.js", "JavaScript", 74, 0, 0, 0, 0, 0, 7, 81
"/Users/jonathanoakes/Desktop/breakfast-and-afterschool-club/src/store/forgot-password-result/forgot-password-result.selector.js", "JavaScript", 18, 0, 0, 0, 0, 0, 6, 24
"/Users/jonathanoakes/Desktop/breakfast-and-afterschool-club/src/store/forgot-password-result/forgot-password-result.slice.js", "JavaScript", 76, 0, 0, 0, 0, 0, 8, 84
"/Users/jonathanoakes/Desktop/breakfast-and-afterschool-club/src/store/hamburger-menu/hamburger-menu.selector.js", "JavaScript", 6, 0, 0, 0, 0, 0, 3, 9
"/Users/jonathanoakes/Desktop/breakfast-and-afterschool-club/src/store/hamburger-menu/hamburger-menu.slice.js", "JavaScript", 19, 0, 0, 0, 0, 0, 5, 24
"/Users/jonathanoakes/Desktop/breakfast-and-afterschool-club/src/store/handle-payment/handle-payment.selector.js", "JavaScript", 26, 0, 0, 0, 0, 0, 8, 34
"/Users/jonathanoakes/Desktop/breakfast-and-afterschool-club/src/store/handle-payment/handle-payment.slice.js", "JavaScript", 152, 0, 0, 0, 0, 0, 13, 165
"/Users/jonathanoakes/Desktop/breakfast-and-afterschool-club/src/store/is-online/is-online.selector.js", "JavaScript", 6, 0, 0, 0, 0, 0, 3, 9
"/Users/jonathanoakes/Desktop/breakfast-and-afterschool-club/src/store/is-online/is-online.slice.js", "JavaScript", 15, 0, 0, 0, 0, 0, 5, 20
"/Users/jonathanoakes/Desktop/breakfast-and-afterschool-club/src/store/magic-url-request/magic-url-request.selector.js", "JavaScript", 18, 0, 0, 0, 0, 0, 6, 24
"/Users/jonathanoakes/Desktop/breakfast-and-afterschool-club/src/store/magic-url-request/magic-url-request.slice.js", "JavaScript", 81, 0, 0, 0, 0, 0, 7, 88
"/Users/jonathanoakes/Desktop/breakfast-and-afterschool-club/src/store/password-is-visible/password-is-visible.selector.js", "JavaScript", 38, 0, 0, 0, 0, 0, 10, 48
"/Users/jonathanoakes/Desktop/breakfast-and-afterschool-club/src/store/password-is-visible/password-is-visible.slice.js", "JavaScript", 87, 0, 0, 0, 0, 0, 5, 92
"/Users/jonathanoakes/Desktop/breakfast-and-afterschool-club/src/store/progressive-image/progressive-image.selector.js", "JavaScript", 6, 0, 0, 0, 0, 0, 3, 9
"/Users/jonathanoakes/Desktop/breakfast-and-afterschool-club/src/store/progressive-image/progressive-image.slice.js", "JavaScript", 16, 0, 0, 0, 0, 0, 6, 22
"/Users/jonathanoakes/Desktop/breakfast-and-afterschool-club/src/store/request-date-data/request-date-data.selector.js", "JavaScript", 18, 0, 0, 0, 0, 0, 6, 24
"/Users/jonathanoakes/Desktop/breakfast-and-afterschool-club/src/store/request-date-data/request-date-data.slice.js", "JavaScript", 89, 0, 0, 0, 0, 0, 8, 97
"/Users/jonathanoakes/Desktop/breakfast-and-afterschool-club/src/store/root-reducer.js", "JavaScript", 49, 0, 0, 0, 0, 0, 3, 52
"/Users/jonathanoakes/Desktop/breakfast-and-afterschool-club/src/store/session-types-and-prices/session-types-and-prices.selector.js", "JavaScript", 27, 0, 0, 0, 0, 0, 7, 34
"/Users/jonathanoakes/Desktop/breakfast-and-afterschool-club/src/store/session-types-and-prices/session-types-and-prices.slice.js", "JavaScript", 36, 0, 0, 0, 0, 0, 4, 40
"/Users/jonathanoakes/Desktop/breakfast-and-afterschool-club/src/store/should-show-element/should-show-element.selector.js", "JavaScript", 10, 0, 0, 0, 0, 0, 4, 14
"/Users/jonathanoakes/Desktop/breakfast-and-afterschool-club/src/store/should-show-element/should-show-element.slice.js", "JavaScript", 43, 0, 0, 0, 0, 0, 5, 48
"/Users/jonathanoakes/Desktop/breakfast-and-afterschool-club/src/store/sign-in-form/sign-in-form.selector.js", "JavaScript", 6, 0, 0, 0, 0, 0, 3, 9
"/Users/jonathanoakes/Desktop/breakfast-and-afterschool-club/src/store/sign-in-form/sign-in-form.slice.js", "JavaScript", 23, 0, 0, 0, 0, 0, 5, 28
"/Users/jonathanoakes/Desktop/breakfast-and-afterschool-club/src/store/sign-up-form/sign-up-form.selector.js", "JavaScript", 6, 0, 0, 0, 0, 0, 3, 9
"/Users/jonathanoakes/Desktop/breakfast-and-afterschool-club/src/store/sign-up-form/sign-up-form.slice.js", "JavaScript", 25, 0, 0, 0, 0, 0, 5, 30
"/Users/jonathanoakes/Desktop/breakfast-and-afterschool-club/src/store/store.js", "JavaScript", 13, 0, 0, 0, 0, 49, 12, 74
"/Users/jonathanoakes/Desktop/breakfast-and-afterschool-club/src/store/update-email/update-email.selector.js", "JavaScript", 18, 0, 0, 0, 0, 0, 6, 24
"/Users/jonathanoakes/Desktop/breakfast-and-afterschool-club/src/store/update-email/update-email.slice.js", "JavaScript", 64, 0, 0, 0, 0, 0, 6, 70
"/Users/jonathanoakes/Desktop/breakfast-and-afterschool-club/src/store/update-password-request/update-password-request.selector.js", "JavaScript", 15, 0, 0, 0, 0, 0, 5, 20
"/Users/jonathanoakes/Desktop/breakfast-and-afterschool-club/src/store/update-password-request/update-password-request.slice.js", "JavaScript", 59, 0, 0, 0, 0, 0, 7, 66
"/Users/jonathanoakes/Desktop/breakfast-and-afterschool-club/src/store/update-password-result/update-password-result.selector.js", "JavaScript", 18, 0, 0, 0, 0, 0, 6, 24
"/Users/jonathanoakes/Desktop/breakfast-and-afterschool-club/src/store/update-password-result/update-password-result.slice.js", "JavaScript", 76, 0, 0, 0, 0, 0, 7, 83
"/Users/jonathanoakes/Desktop/breakfast-and-afterschool-club/src/store/upload-dates-to-database/upload-dates-to-database.selector.js", "JavaScript", 15, 0, 0, 0, 0, 0, 5, 20
"/Users/jonathanoakes/Desktop/breakfast-and-afterschool-club/src/store/upload-dates-to-database/upload-dates-to-database.slice.js", "JavaScript", 61, 0, 0, 0, 0, 0, 8, 69
"/Users/jonathanoakes/Desktop/breakfast-and-afterschool-club/src/store/user/functions.js", "JavaScript", 54, 0, 0, 0, 0, 0, 11, 65
"/Users/jonathanoakes/Desktop/breakfast-and-afterschool-club/src/store/user/user.actions.js", "JavaScript", 132, 0, 0, 0, 0, 20, 19, 171
"/Users/jonathanoakes/Desktop/breakfast-and-afterschool-club/src/store/user/user.selector.js", "JavaScript", 14, 0, 0, 0, 0, 3, 6, 23
"/Users/jonathanoakes/Desktop/breakfast-and-afterschool-club/src/store/user/user.slice.js", "JavaScript", 122, 0, 0, 0, 0, 0, 7, 129
"/Users/jonathanoakes/Desktop/breakfast-and-afterschool-club/src/store/wallet-funds-to-add/wallet-funds-to-add.selector.js", "JavaScript", 6, 0, 0, 0, 0, 0, 3, 9
"/Users/jonathanoakes/Desktop/breakfast-and-afterschool-club/src/store/wallet-funds-to-add/wallet-funds-to-add.slice.js", "JavaScript", 19, 0, 0, 0, 0, 0, 5, 24
"/Users/jonathanoakes/Desktop/breakfast-and-afterschool-club/src/strings/strings.js", "JavaScript", 201, 0, 0, 0, 0, 6, 8, 215
"/Users/jonathanoakes/Desktop/breakfast-and-afterschool-club/src/styles/buttons/buttons.styles.jsx", "JavaScript", 75, 0, 0, 0, 0, 0, 13, 88
"/Users/jonathanoakes/Desktop/breakfast-and-afterschool-club/src/styles/colors.js", "JavaScript", 31, 0, 0, 0, 0, 0, 1, 32
"/Users/jonathanoakes/Desktop/breakfast-and-afterschool-club/src/styles/confirm.css", "CSS", 0, 0, 31, 0, 0, 0, 6, 37
"/Users/jonathanoakes/Desktop/breakfast-and-afterschool-club/src/styles/container/container.styles.jsx", "JavaScript", 13, 0, 0, 0, 0, 0, 4, 17
"/Users/jonathanoakes/Desktop/breakfast-and-afterschool-club/src/styles/div/div.styles.jsx", "JavaScript", 284, 0, 0, 0, 0, 5, 49, 338
"/Users/jonathanoakes/Desktop/breakfast-and-afterschool-club/src/styles/form/form.styles.jsx", "JavaScript", 300, 0, 0, 0, 0, 2, 64, 366
"/Users/jonathanoakes/Desktop/breakfast-and-afterschool-club/src/styles/h1/h1.styles.jsx", "JavaScript", 8, 0, 0, 0, 0, 0, 3, 11
"/Users/jonathanoakes/Desktop/breakfast-and-afterschool-club/src/styles/h2/h2.styles.jsx", "JavaScript", 6, 0, 0, 0, 0, 0, 2, 8
"/Users/jonathanoakes/Desktop/breakfast-and-afterschool-club/src/styles/hr/hr.styles.jsx", "JavaScript", 13, 0, 0, 0, 0, 0, 4, 17
"/Users/jonathanoakes/Desktop/breakfast-and-afterschool-club/src/styles/image/image.styles.jsx", "JavaScript", 52, 0, 0, 0, 0, 0, 12, 64
"/Users/jonathanoakes/Desktop/breakfast-and-afterschool-club/src/styles/link/link.styles.jsx", "JavaScript", 17, 0, 0, 0, 0, 0, 6, 23
"/Users/jonathanoakes/Desktop/breakfast-and-afterschool-club/src/styles/p/p.styles.jsx", "JavaScript", 31, 0, 0, 0, 0, 0, 8, 39
"/Users/jonathanoakes/Desktop/breakfast-and-afterschool-club/src/styles/span/span.styles.jsx", "JavaScript", 137, 0, 0, 0, 0, 0, 24, 161
"/Users/jonathanoakes/Desktop/breakfast-and-afterschool-club/src/styles/svg/svg.styles.jsx", "JavaScript", 28, 0, 0, 0, 0, 0, 6, 34
"/Users/jonathanoakes/Desktop/breakfast-and-afterschool-club/src/utils/appwrite/appwrite-config.js", "JavaScript", 8, 0, 0, 0, 0, 1, 5, 14
"/Users/jonathanoakes/Desktop/breakfast-and-afterschool-club/src/utils/stripe/stripe.utils.js", "JavaScript", 4, 0, 0, 0, 0, 0, 2, 6
"/Users/jonathanoakes/Desktop/breakfast-and-afterschool-club/vite.config.js", "JavaScript", 18, 0, 0, 0, 0, 12, 1, 31
"Total", "-", 10368, 206, 46, 81, 21, 149, 1946, 12817